,osn,candidate,party,evm_votes,postal_votes,total_votes,percentage_votes,contituencty
0,1,Dhirendra Pratap Singh alias Rinku singh,Janata Dal (United),74777,129,74906,38.32,1
1,2,Baidyanath Prasad,Bahujan Samaj Party,14475,23,14498,7.42,1
2,3,Mahendra Kumar Bharti,Lok Jan Shakti Party,6602,10,6612,3.38,1
3,4,Rajesh Singh,Indian National Congress,52952,369,53321,27.28,1
4,5,Gaurav Jha,The Plurals Party,2862,1,2863,1.46,1
5,6,Deepak Kumar Malakar,Bhartiya Party (Loktantrik),4279,0,4279,2.19,1
6,7,Saket Kumar Pathak,"Jan Sangharsh Dal,",2733,2,2735,1.4,1
7,8,Sumant Kumar,Jan Adhikar Party (Loktantrik),18372,37,18409,9.42,1
8,9,Kumari Rajwanti Kushwaha,Independent,1992,4,1996,1.02,1
9,10,Tirthraj Yadav,Independent,2512,3,2515,1.29,1
10,11,Mahmad Jalil,Independent,2655,2,2657,1.36,1
11,12,Rajesh Kumar,Independent,2607,1,2608,1.33,1
12,13,NOTA,None of the Above,8088,2,8090,4.14,1
0,1,Bhagirathi Devi,Bharatiya Janata Party,75360,63,75423,39.57,2
1,2,Rajesh Ram,Indian National Congress,59273,354,59627,31.28,2
2,3,Lokesh Ram,Rashtriya Lok Samta Party,4048,3,4051,2.13,2
3,4,Champa Devi,The Plurals Party,1409,3,1412,0.74,2
4,5,Lorik Das,Fauji Kisan Party,4329,2,4331,2.27,2
5,6,Vinay Ram,Janta Dal Rashtravadi,3213,2,3215,1.69,2
6,7,Subodh Kumar,Bhartiya Panchyat Party,26029,34,26063,13.67,2
7,8,Awadh Kishor Ram,Independent,3109,2,3111,1.63,2
8,9,Ayush Kumar,Independent,2670,1,2671,1.4,2
9,10,Ramnaresh Baitha,Independent,2454,6,2460,1.29,2
10,11,Ramayan Paswan,Independent,3791,2,3793,1.99,2
11,12,NOTA,None of the Above,4453,3,4456,2.34,2
0,1,NAUSHAD AHMAD,Lok Jan Shakti Party,5400,8,5408,3.29,3
1,2,MANJEET KUMAR VERMA,Rashtriya Lok Samta Party,2911,2,2913,1.77,3
2,3,MOHAMMAD RASHID AZIM,Nationalist Congress Party,1291,3,1294,0.79,3
3,4,RASHMI VARMA,Bharatiya Janata Party,75345,139,75484,45.85,3
4,5,VINAY VARMA,Indian National Congress,53826,524,54350,33.02,3
5,6,ANUP KUMAR MISHRA,The Plurals Party,958,1,959,0.58,3
6,7,AFSAR IMAM,Jan Adhikar Party (Loktantrik),1250,5,1255,0.76,3
7,8,AVINASH KUMAR,Bhartiya Sablog Party,673,1,674,0.41,3
8,9,GULREZ HODA,"Jan Sangharsh Dal,",1109,4,1113,0.68,3
9,10,MUKESH KUMAR,Bharat Jan Jagran Dal,692,1,693,0.42,3
10,11,MUNNA SINGH,Fauji Kisan Party,948,0,948,0.58,3
11,12,RAMCHANDRA MAHTO,Jai Maha Bharath Party,1147,1,1148,0.7,3
12,13,VIJAY RAM,Janta Dal Rashtravadi,979,0,979,0.59,3
13,14,ANIL KUMAR MISHRA,Independent,1420,9,1429,0.87,3
14,15,NAZNIM KHANAM,Independent,994,4,998,0.61,3
15,16,NATHU RAVI,Independent,2047,4,2051,1.25,3
16,17,BABLU KUMAR GUPTA,Independent,1805,0,1805,1.1,3
17,18,MITHLESH TIWARY,Independent,1085,3,1088,0.66,3
18,19,RUPN SINGH,Independent,705,0,705,0.43,3
19,20,RENU DEVI,Independent,7638,36,7674,4.66,3
20,21,NOTA,None of the Above,1645,2,1647,1,3
0,1,JAYESH MANGLAM SINGH,Indian National Congress,59388,605,59993,33,4
1,2,RAM SINGH,Bharatiya Janata Party,89882,131,90013,49.51,4
2,3,ATUL KUMAR SHUKLA,Lok Shakti Party (Loktantrik),2363,1,2364,1.3,4
3,4,UMESH GUPTA,Rashtriya Jansambhavna Party,1621,1,1622,0.89,4
4,5,DALSINGAR RAM,Bahujan Maha Party,862,0,862,0.47,4
5,6,DURGESH SINGH CHAUHAN,Bihar Lok Nirman Dal,1159,3,1162,0.64,4
6,7,PURNMASI RAM,"Jan Sangharsh Dal,",3626,23,3649,2.01,4
7,8,MANOJ KUMAR,Bharat Jan Jagran Dal,1446,0,1446,0.8,4
8,9,RADHESHYAM YADAV,Fauji Kisan Party,1442,2,1444,0.79,4
9,10,SHESH NATH CHAUDHARY,Bhartiya Rashtriya Dal,1404,2,1406,0.77,4
10,11,SITA SHAH,The Plurals Party,1031,1,1032,0.57,4
11,12,SURESH MUKHIYA,Janvadi Party(Socialist),2597,3,2600,1.43,4
12,13,KAMRAN AZIZ,Independent,3067,10,3077,1.69,4
13,14,MANOJ KUMAR RAO,Independent,1243,1,1244,0.68,4
14,15,RAGHAW SHARAN PANDEY,Independent,6381,48,6429,3.54,4
15,16,NOTA,None of the Above,3454,2,3456,1.9,4
0,1,Ran Kaushal Pratap Singh,Bahujan Samaj Party,17487,28,17515,11.12,5
1,2,Vinay Bihari,Bharatiya Janata Party,77852,75,77927,49.48,5
2,3,Shambhu Tiwari,Rashtriya Janata Dal,48680,243,48923,31.06,5
3,4,Ajitesh Kumar,The Plurals Party,1462,0,1462,0.93,5
4,5,Abdul Quyum,"Jan Sangharsh Dal,",1163,2,1165,0.74,5
5,6,Ranjit Kumar,Janta Dal Rashtravadi,1088,0,1088,0.69,5
6,7,Sima Devi,Jan Adhikar Party (Loktantrik),1204,2,1206,0.77,5
7,8,Kamlesh Singh,Independent,1394,0,1394,0.89,5
8,9,Doctor Mahto,Independent,1541,0,1541,0.98,5
9,10,Neelam Singh,Independent,1906,0,1906,1.21,5
10,11,NOTA,None of the Above,3367,1,3368,2.14,5
0,1,NANDKISHOR PRASAD,Rashtriya Lok Samta Party,4573,14,4587,2.74,6
1,2,NARAYAN PRASAD,Bharatiya Janata Party,78543,114,78657,46.97,6
2,3,SHEIKH MOHAMMAD KAMRAN,Indian National Congress,52437,324,52761,31.51,6
3,4,JAY PRAKASH SINGH KUSHWAHA,The Plurals Party,1164,5,1169,0.7,6
4,5,PUNYADEO PRASAD,Jagrook Janta Party,586,6,592,0.35,6
5,6,YADAVENDRA KUMAR,Jan Adhikar Party (Loktantrik),1101,2,1103,0.66,6
6,7,MD. SHAHNAWAZ,"Jan Sangharsh Dal,",951,1,952,0.57,6
7,8,SURENDRA CHOUDHARY,Janta Dal Rashtravadi,537,1,538,0.32,6
8,9,ADARSH KUMAR,Independent,859,1,860,0.51,6
9,10,PRIYA RANJAN,Independent,1088,1,1089,0.65,6
10,11,MANORAMA PRASAD,Independent,15357,64,15421,9.21,6
11,12,RATAN KUMAR SARKAR,Independent,825,2,827,0.49,6
12,13,LALAN RAI,Independent,1285,6,1291,0.77,6
13,14,VIKASH KUMAR PRASAD,Independent,3967,0,3967,2.37,6
14,15,SHUBHAM KUMAR DUBEY,Independent,1823,1,1824,1.09,6
15,16,NOTA,None of the Above,1808,5,1813,1.08,6
0,1,Abhishek Ranjan,Indian National Congress,69940,419,70359,40.03,7
1,2,Umakant Singh,Bharatiya Janata Party,83620,208,83828,47.69,7
2,3,Santosh Kumar Gupta,Rashtriya Lok Samta Party,3520,6,3526,2.01,7
3,4,Ravisagar Bharati,Aazad Samaj Party (Kanshi Ram),727,3,730,0.42,7
4,5,Rajeev Ranjan,The Plurals Party,297,0,297,0.17,7
5,6,Bipin Nath Tiwari Alias Bipin Tiwari,Loktantrik Jan Swaraj Party,336,3,339,0.19,7
6,7,Shekh Firoz,Vanchit Samaj Party,689,1,690,0.39,7
7,8,Sanjay Ram,Proutist Sarva Samaj,321,1,322,0.18,7
8,9,Om Prakash Jaiswal,Independent,344,2,346,0.2,7
9,10,Tripurari Kr. Tiwari @ Manish kasyap,Independent,9207,32,9239,5.26,7
10,11,Munna Singh,Independent,873,2,875,0.5,7
11,12,Ramayan Yadav,Independent,937,1,938,0.53,7
12,13,Sheshnath Bharti,Independent,1374,1,1375,0.78,7
13,14,NOTA,None of the Above,2907,3,2910,1.66,7
0,1,Parwez Alam,Nationalist Congress Party,1183,9,1192,0.75,8
1,2,Madan Mohan Tiwari,Indian National Congress,65864,553,66417,41.53,8
2,3,Renu Devi,Bharatiya Janata Party,84239,257,84496,52.83,8
3,4,Avkash Kumar Gupta,The Plurals Party,1556,3,1559,0.97,8
4,5,Nand Lal Prasad,Apna Kisan Party,607,3,610,0.38,8
5,6,Barkat Ahmad,"Jan Sangharsh Dal,",421,4,425,0.27,8
6,7,Yuvraj Navin Singh,Bhartiya Panchyat Party,543,3,546,0.34,8
7,8,Savita Singh Nepali,Jan Adhikar Party (Loktantrik),675,2,677,0.42,8
8,9,Sitaram Sahani,Rashtriya mahan Gantantra Party,1012,0,1012,0.63,8
9,10,Sameer Hasen,Independent,980,1,981,0.61,8
10,11,NOTA,None of the Above,2009,8,2017,1.26,8
0,1,KHURSHID FIROZ AHMAD,Janata Dal (United),35713,85,35798,21.05,9
1,2,MAINUDDIN ALAM,Nationalist Congress Party,2018,5,2023,1.19,9
2,3,AKHILESHWAR PRASAD ALIAS JHUNU,Bhartiya Panchyat Party,3306,6,3312,1.95,9
3,4,AASMA KHATOON,"Jan Sangharsh Dal,",1308,1,1309,0.77,9
4,5,TAMNNA KHATUN,The Plurals Party,2234,3,2237,1.32,9
5,6,MALKHAN SINGH,Janata Congress,1612,1,1613,0.95,9
6,7,RAJESH PASWAN,Peoples Party of India (Democratic),2362,0,2362,1.39,9
7,8,RIJABANULLAH ALIAS RIZWAN RIYAZI,All India Majlis-E-Ittehadul Muslimeen,8511,8,8519,5.01,9
8,9,BIRENDRA PRASAD GUPTA,Communist Party of India  (Marxist-Leninist)  (Liberation),48730,345,49075,28.85,9
9,10,SANDEEP PATEL,Jan Adhikar Party,1393,0,1393,0.82,9
10,11,GHAUSUL AZAM,Independent,2458,3,2461,1.45,9
11,12,DILIP VARMA,Independent,46650,123,46773,27.5,9
12,13,RAMJEE PRASAD,Independent,1745,1,1746,1.03,9
13,14,WASI AHMAD,Independent,2682,4,2686,1.58,9
14,15,VINAY KUMAR YADAV,Independent,4151,9,4160,2.45,9
15,16,HARDEV RAM,Independent,2588,0,2588,1.52,9
16,17,NOTA,None of the Above,2021,1,2022,1.19,9
0,1,Dr. Ajay Kumar Singh,Bahujan Samaj Party,12193,74,12267,6.91,10
1,2,Pramod Kumar Sinha,Bharatiya Janata Party,80794,185,80979,45.6,10
2,3,Rambabu Prashad Yadav,Indian National Congress,43700,356,44056,24.81,10
3,4,Umang Kumar Gupta,Jai Maha Bharath Party,941,1,942,0.53,10
4,5,Kundan Kumar,The Plurals Party,687,7,694,0.39,10
5,6,Devendra Kumar Singh,Rashtra Sewa Dal,478,1,479,0.27,10
6,7,Bablu Kumar,Janata Congress,384,0,384,0.22,10
7,8,Haider Ali,Janta Dal Rashtravadi,563,2,565,0.32,10
8,9,Arbind Prasad Sah,Independent,2193,4,2197,1.24,10
9,10,Bhulan Kumar,Independent,444,3,447,0.25,10
10,11,Madan Prasad,Independent,957,3,960,0.54,10
11,12,Mustaque Ali,Independent,2236,0,2236,1.26,10
12,13,Suresh Kumar,Independent,28523,70,28593,16.1,10
13,14,NOTA,None of the Above,2783,1,2784,1.57,10
0,1,Vijay Prasad Gupta,Lok Jan Shakti Party,14117,71,14188,8.32,11
1,2,Er. Shashi Bhushan Singh,Rashtriya Janata Dal,64757,510,65267,38.26,11
2,3,Sant Singh Kushwaha,Rashtriya Lok Samta Party,6677,33,6710,3.93,11
3,4,Asha Devi,Hindu Samaj Party,1178,3,1181,0.69,11
4,5,Zulfiquar Aftab,Janta Dal Rashtravadi,1550,0,1550,0.91,11
5,6,Mahmad Sohail Sahil,Jan Adhikar Party (Loktantrik),904,13,917,0.54,11
6,7,Ramchandra Sahni,Vikassheel Insaan Party,61712,108,61820,36.24,11
7,8,Vinod Kumar Mahto,Jago Hindustan Party,2497,2,2499,1.46,11
8,9,Shekh Alauddin,"Jan Sangharsh Dal,",1973,0,1973,1.16,11
9,10,Sadre Alam,All India Minorities Front,3430,1,3431,2.01,11
10,11,Akhilesh Kumar Mishra,Independent,2388,5,2393,1.4,11
11,12,Anita Devi,Independent,1079,0,1079,0.63,11
12,13,Amrit Raj,Independent,1850,4,1854,1.09,11
13,14,Vishnu Prasad Gupta,Independent,1558,0,1558,0.91,11
14,15,Shekh Manjar Hussain,Independent,1970,0,1970,1.15,11
15,16,NOTA,None of the Above,2191,2,2193,1.29,11
0,1,SHAMIM AHMAD,Rashtriya Janata Dal,84970,592,85562,46.69,12
1,2,SHYAM BIHARI PRASAD,Janata Dal (United),57593,178,57771,31.53,12
2,3,SONU KUMAR,Lok Jan Shakti Party,20446,48,20494,11.18,12
3,4,ASHARFI PANDIT,Proutist Sarva Samaj,878,0,878,0.48,12
4,5,OM PRAKASH GUPTA,Janta Dal Rashtravadi,986,2,988,0.54,12
5,6,RAVI SHANKAR RAVI,Jan Adhikar Party (Loktantrik),609,1,610,0.33,12
6,7,RAJ KISHOR KUMAR,Lok Shakti Party (Loktantrik),397,1,398,0.22,12
7,8,UMASHANKAR PRASAD,Independent,299,0,299,0.16,12
8,9,MANISH KUMAR,Independent,388,0,388,0.21,12
9,10,MOHAMMAD TAIYAB,Independent,966,2,968,0.53,12
10,11,VIDYANAND PRASAD,Independent,1704,2,1706,0.93,12
11,12,SANJAY KUMAR,Independent,2100,4,2104,1.15,12
12,13,SURESH PRASAD YADAV,Independent,6135,14,6149,3.36,12
13,14,NOTA,None of the Above,4935,1,4936,2.69,12
0,1,Kumar Nagendra Bihari,Rashtriya Janata Dal,68360,570,68930,40.5,13
1,2,Krishnanandan Paswan,Bharatiya Janata Party,84431,184,84615,49.71,13
2,3,Ramesh Kumar,Rashtriya Lok Samta Party,10478,45,10523,6.18,13
3,4,Sunil Kumar,Nationalist Congress Party,533,0,533,0.31,13
4,5,Satya Prakash,Peoples Party of India (Democratic),375,0,375,0.22,13
5,6,Jagdish Ram,Independent,615,2,617,0.36,13
6,7,Dinesh Kumar Chaudhary,Independent,1674,0,1674,0.98,13
7,8,NOTA,None of the Above,2931,7,2938,1.73,13
0,1,BRAJESH KUMAR,Indian National Congress,37620,0,37620,24.81,14
1,2,RAJU TIWARI,Lok Jan Shakti Party,31300,0,31300,20.64,14
2,3,VISWANATH PRASAD,Bahujan Samaj Party,3250,0,3250,2.14,14
3,4,SUNIL MANI TIWARI,Bharatiya Janata Party,65544,0,65544,43.22,14
4,5,PAPPU GIRI,Yuva Krantikari Party,1616,0,1616,1.07,14
5,6,MANORANJAN KUMAR MISHRA,The Plurals Party,481,0,481,0.32,14
6,7,ASHOK SINGH,Independent,518,0,518,0.34,14
7,8,YUVRAJ PANDEY,Independent,1404,0,1404,0.93,14
8,9,RANJAY RAI,Independent,1990,0,1990,1.31,14
9,10,VIPIN KANT TIWARI,Independent,1626,0,1626,1.07,14
10,11,SARVESH KUMAR TIWARI,Independent,3301,0,3301,2.18,14
11,12,NOTA,None of the Above,3002,0,3002,1.98,14
0,1,Abhay Kumar Singh,Bahujan Samaj Party,2121,10,2131,1.41,15
1,2,Maheshwar Singh,Rashtriya Lok Samta Party,18495,81,18576,12.28,15
2,3,Ram Sharn Prasad Yadav,Lok Jan Shakti Party,18839,65,18904,12.5,15
3,4,Shalini Mishra,Janata Dal (United),40093,126,40219,26.59,15
4,5,Santosh Kushwha,Rashtriya Janata Dal,30741,251,30992,20.49,15
5,6,Azharuddin Khan,"Jan Sangharsh Dal,",907,1,908,0.6,15
6,7,Anu Vivek,The Plurals Party,616,3,619,0.41,15
7,8,Ambesh Kumar Yadav,Rashtriya Janwadi Party (Socialist),599,1,600,0.4,15
8,9,Krishna Kumar Jaiswal,Rashtra Sewa Dal,580,1,581,0.38,15
9,10,Brajesh Mishra,Hindu Samaj Party,721,0,721,0.48,15
10,11,Rajanish Kumar Pathak,Jan Adhikar Party (Loktantrik),7188,29,7217,4.77,15
11,12,Ram Adhar Rai,Bahujan Nyay Dal,2020,0,2020,1.34,15
12,13,Amrendra Kumar Verma,Independent,2554,1,2555,1.69,15
13,14,Ravindra Kumar Berwar,Independent,3633,2,3635,2.4,15
14,15,Dr. Rajesh Kumar,Independent,17658,71,17729,11.72,15
15,16,Rajesh Yadav,Independent,1876,1,1877,1.24,15
16,17,Varun Vijay,Independent,511,1,512,0.34,15
17,18,NOTA,None of the Above,1483,0,1483,0.98,15
0,1,Manoj Kumar Yadav,Rashtriya Janata Dal,72236,583,72819,45.35,16
1,2,Mohammad Badiuzzaman,Bahujan Samaj Party,6335,32,6367,3.97,16
2,3,Sachindra Prasad Singh,Bharatiya Janata Party,71384,242,71626,44.61,16
3,4,Mala Thakur,Janta Dal Rashtravadi,1992,14,2006,1.25,16
4,5,Satyam Yadav,Jan Adhikar Party (Loktantrik),478,0,478,0.3,16
5,6,Subodh Kumar Thakur,Bhartiya Vikash Dal United,430,0,430,0.27,16
6,7,Muneshwar Tiwari,Independent,523,1,524,0.33,16
7,8,Rajesh Kumar Singh,Independent,1623,0,1623,1.01,16
8,9,Rituraj Pandey,Independent,1790,7,1797,1.12,16
9,10,NOTA,None of the Above,2883,4,2887,1.8,16
0,1,RAJMANGAL PRASAD,Communist Party of India  (Marxist),79753,657,80410,40.1,17
1,2,SHYAMBABU PRASAD YADAV,Bharatiya Janata Party,88358,229,88587,44.18,17
2,3,SUBHASH SINGH KUSHWAHA,Rashtriya Lok Samta Party,3225,18,3243,1.62,17
3,4,ANKUSH KUMAR SINGH,Jan Adhikar Party (Loktantrik),1227,6,1233,0.61,17
4,5,ANIKET RANJAN,Rashtriya Jan Jan Party,2827,25,2852,1.42,17
5,6,TUPTI KUMARI,Janta Dal Rashtravadi,687,2,689,0.34,17
6,7,RANI KUMARI,Swabhiman Party,572,0,572,0.29,17
7,8,RAMCHANDRA SAH,Rashtriya Jansambhavna Party,884,0,884,0.44,17
8,9,LALIT KUMAR SINGH,Bahujan Mukti Party,555,2,557,0.28,17
9,10,AJAY KUMAR SHUKLA,Independent,552,3,555,0.28,17
10,11,AFZAL,Independent,667,4,671,0.33,17
11,12,AWADHESH Pd KUSHWAHA,Independent,6901,39,6940,3.46,17
12,13,ASHOK KUMAR SUMAN,Independent,1085,0,1085,0.54,17
13,14,MD. MUMTAZ ALAM,Independent,2184,1,2185,1.09,17
14,15,SHYAM NANDAN KUMAR,Independent,3693,1,3694,1.84,17
15,16,NOTA,None of the Above,6339,5,6344,3.16,17
0,1,Madan Prasad,Rashtriya Janata Dal,66831,470,67301,43.86,18
1,2,Rana Randhir,Bharatiya Janata Party,72946,233,73179,47.69,18
2,3,Shiv Shankar Ray,Bahujan Samaj Party,1250,1,1251,0.82,18
3,4,Aysa Khatoon,"Jan Sangharsh Dal,",376,2,378,0.25,18
4,5,Jagdish Prasad,Bajjikanchal Vikas Party,340,0,340,0.22,18
5,6,Rajesh Kumar Singh,Janta Dal Rashtravadi,416,1,417,0.27,18
6,7,Vikash Keshari,The Plurals Party,427,0,427,0.28,18
7,8,Shivjee Ray,Jan Adhikar Party (Loktantrik),2078,4,2082,1.36,18
8,9,Sanjay Tiwari,Bhartiya Aam Janta Vikas Party,416,0,416,0.27,18
9,10,Dinesh Ram,Independent,384,0,384,0.25,18
10,11,Madan Singh Alias Madan Prasad,Independent,902,0,902,0.59,18
11,12,Shashi Ranjan Kumar,Independent,2639,0,2639,1.72,18
12,13,NOTA,None of the Above,3731,1,3732,2.43,18
0,1,OM PRAKASH CHAUDHARY,Rashtriya Janata Dal,77361,727,78088,41.63,19
1,2,DEEPAK KUMAR KUSHWAHA,Rashtriya Lok Samta Party,3692,24,3716,1.98,19
2,3,PRAMOD KUMAR,Bharatiya Janata Party,92348,385,92733,49.44,19
3,4,ASHOK KUMAR,"Jan Sangharsh Dal,",1060,0,1060,0.57,19
4,5,ASHWINI KUMAR GUPTA,Akhand Bhartiya Yuva Party,213,0,213,0.11,19
5,6,PANKAJ KUMAR SRIVASTAV,Jantantrik Vikas Party,211,0,211,0.11,19
6,7,PRAKASH CHANDRA MANU,Rashtriya Jan Jan Party,363,1,364,0.19,19
7,8,PRABHU NANDAN PRASAD,Janata Party,669,7,676,0.36,19
8,9,BAIJU KUMAR,Rashtra Sewa Dal,293,0,293,0.16,19
9,10,MUNNA KUMAR,The Plurals Party,651,11,662,0.35,19
10,11,HARISHCHANDRA PANDIT,Vanchit Samaj Party,375,0,375,0.2,19
11,12,ABHISHEK KUMAR SINGH,Independent,597,2,599,0.32,19
12,13,ZALALUDDIN ROY,Independent,1846,1,1847,0.98,19
13,14,RAMESHVAR SAH,Independent,3255,8,3263,1.74,19
14,15,NOTA,None of the Above,3436,19,3455,1.84,19
0,1,Achchhelal  Prasad,Rashtriya Janata Dal,45578,452,46030,27.53,20
1,2,Pawan Kumar Singh,National People's Party,649,0,649,0.39,20
2,3,Madhurendra Kumar Singh,Rashtriya Lok Samta Party,4504,14,4518,2.7,20
3,4,Lal Babu Prasad Gupta,Bharatiya Janata Party,62794,110,62904,37.62,20
4,5,Abhinav Bharti,The Plurals Party,1416,16,1432,0.86,20
5,6,Usha Rani,"Bhartiya Garibmazdoor Party,",464,0,464,0.28,20
6,7,Jalaluddin Ahamad,Rashtriya Jan-Jagran Morcha,262,0,262,0.16,20
7,8,Bhushan Shah,Fauji Kisan Party,695,1,696,0.42,20
8,9,Mohammad Firoj Ahmad,"Jan Sangharsh Dal,",664,4,668,0.4,20
9,10,Lalsa Devi,Jan Adhikar Party (Loktantrik),1066,2,1068,0.64,20
10,11,Vijay Singh,Janta Dal Rashtravadi,656,0,656,0.39,20
11,12,Sanjay Kumar,Shiv Sena,785,4,789,0.47,20
12,13,Sudhir Kumar Singh,Bhartiya Aam Janta Vikas Party,1255,0,1255,0.75,20
13,14,Suresh Kumar,Lok Shakti Party (Loktantrik),570,0,570,0.34,20
14,15,Akhileshwar Kumar,Independent,742,3,745,0.45,20
15,16,Avaneesh Kumar Singh,Independent,11398,32,11430,6.84,20
16,17,Prabhash Ranjan Urf Chandan,Independent,1917,6,1923,1.15,20
17,18,Fahim Hussain,Independent,321,0,321,0.19,20
18,19,Raj Vanshi Mahato,Independent,987,0,987,0.59,20
19,20,Radhakant sah,Independent,1355,0,1355,0.81,20
20,21,Laxmi Narayan Prasad Yadav,Independent,16283,112,16395,9.81,20
21,22,Sanjay Kumar,Independent,9227,46,9273,5.55,20
22,23,Sanjay Kumar Yadav,Independent,470,0,470,0.28,20
23,24,Hiralal Ray,Independent,804,1,805,0.48,20
24,25,NOTA,None of the Above,1525,1,1526,0.91,20
0,1,PAWAN KUMAR JAISWAL,Bharatiya Janata Party,99533,259,99792,48.01,21
1,2,FAISAL RAHMAN,Rashtriya Janata Dal,89137,541,89678,43.15,21
2,3,RAM PUKAR SINHA,Rashtriya Lok Samta Party,10907,25,10932,5.26,21
3,4,ABHIJIT SINGH,Jan Adhikar Party (Loktantrik),965,1,966,0.46,21
4,5,DR. RAJAN JAISWAL,The Plurals Party,874,1,875,0.42,21
5,6,RAMKRIT PASWAN,"Jan Sangharsh Dal,",250,0,250,0.12,21
6,7,MD. KASIM ANSARI,Independent,498,1,499,0.24,21
7,8,CHANDRADIP KUMAR,Independent,570,0,570,0.27,21
8,9,MD SALIM MANSURI,Independent,1313,0,1313,0.63,21
9,10,NOTA,None of the Above,2959,6,2965,1.43,21
0,1,CHETAN ANAND,Rashtriya Janata Dal,72818,325,73143,42.69,22
1,2,VIJAY KUMAR PANDEY,Lok Jan Shakti Party,18704,44,18748,10.94,22
2,3,MD. SHARFUDDIN,Janata Dal (United),36357,100,36457,21.28,22
3,4,SANJEEV KUMAR GUPTA,Bahujan Samaj Party,4040,9,4049,2.36,22
4,5,AMRENDRA KUMAR,Bajjikanchal Vikas Party,1049,0,1049,0.61,22
5,6,NATHUNI MAHTO,All India Forward Bloc,798,12,810,0.47,22
6,7,MOHAMAD MANTJIR ALAM,Rashtriya Secular Majlis Party,940,0,940,0.55,22
7,8,MOHAMMED WAMIQUE,Jan Adhikar Party (Loktantrik),3396,19,3415,1.99,22
8,9,RANJEEV KUMAR JHA,The Plurals Party,1246,2,1248,0.73,22
9,10,SHRINARAYAN SINGH,Janta Dal Rashtravadi,3940,12,3952,2.31,22
10,11,SANJAY PRASAD,Rashtriya Jansambhavna Party,1171,2,1173,0.68,22
11,12,ANGESH KUMAR,Independent,1489,0,1489,0.87,22
12,13,RADHA KANT GUPTA,Independent,14157,21,14178,8.28,22
13,14,VIRENDRA PRA. YADAV,Independent,4029,1,4030,2.35,22
14,15,Sanjay Sangharsh Singh,Independent,2930,4,2934,1.71,22
15,16,NOTA,None of the Above,3710,1,3711,2.17,22
0,1,AMIT KUMAR,Indian National Congress,62250,481,62731,34.96,23
1,2,MUNNI SINGH,Bahujan Samaj Party,4242,13,4255,2.37,23
2,3,MOTI LAL PRASAD,Bharatiya Janata Party,95101,125,95226,53.07,23
3,4,RAMBABU SAH S/O-SHRI NATHUNI SAH,Nationalist Congress Party,1410,0,1410,0.79,23
4,5,AKHILESH KUMAR SUMAN,Samata Party,454,1,455,0.25,23
5,6,UPENDRA SAHANI,Rashtriya Jansambhavna Party,618,0,618,0.34,23
6,7,GHUFRAN ASAD,"Jan Sangharsh Dal,",564,1,565,0.31,23
7,8,BINDESHWAR SAH,Prabal Bharat Party,297,0,297,0.17,23
8,9,BHARAT PATEL,Jai Maha Bharath Party,246,0,246,0.14,23
9,10,MOHAN SINGH,Rashtriya Janshakti Party (Secular),702,2,704,0.39,23
10,11,RAVI KUMAR,The Plurals Party,632,2,634,0.35,23
11,12,RAVI SHANKAR PRASAD,Jan Adhikar Party (Loktantrik),623,0,623,0.35,23
12,13,BINDESHWAR MAHTO,Republican Party of India (Athawale),630,0,630,0.35,23
13,14,SAMSUDDIN ANSARI,Bahujan Mukti Party,2340,3,2343,1.31,23
14,15,ABHISHEK RAJA,Independent,667,0,667,0.37,23
15,16,GIRDHARI SAH,Independent,2617,0,2617,1.46,23
16,17,CHANDRIKA PRASAD,Independent,1574,0,1574,0.88,23
17,18,DILIP KUMAR SHRIVASTAV,Independent,358,0,358,0.2,23
18,19,DEVENDRA KUMAR SINHA,Independent,1582,1,1583,0.88,23
19,20,BRAHMDEV NAYAK,Independent,403,0,403,0.22,23
20,21,MOTI LAL RAUT,Independent,449,0,449,0.25,23
21,22,"RAM BABU SAH, S/O- NEWALAL SAH",Independent,224,0,224,0.12,23
22,23,NOTA,None of the Above,830,7,837,0.47,23
0,1,ANIL KUMAR,Bharatiya Janata Party,92426,222,92648,54.15,24
1,2,CHANDRIKA PASWAN,Rashtriya Lok Samta Party,15259,63,15322,8.96,24
2,3,SANJAY RAM,Indian National Congress,45290,540,45830,26.79,24
3,4,KUNKUN MANJHI,Peoples Party of India (Democratic),950,3,953,0.56,24
4,5,RAVI RANJAN PASWAN,Janata Party,462,1,463,0.27,24
5,6,RAJESH PASWAN,Rashtriya Jansambhavna Party,623,0,623,0.36,24
6,7,VIJAY PASWAN,Kisan Party of India,469,0,469,0.27,24
7,8,SHANKAR KUMAR PASWAN,Rashtrawadi Janlok Party (Satya),459,1,460,0.27,24
8,9,SHIV MANGAL PASWAN,Bahujan Mukti Party,627,2,629,0.37,24
9,10,ANITA DEVI,Independent,578,2,580,0.34,24
10,11,KUMAR PURUSHOTTAM,Independent,638,1,639,0.37,24
11,12,RAMPHL SADA,Independent,1863,2,1865,1.09,24
12,13,LALU DAS,Independent,2481,1,2482,1.45,24
13,14,VIJAY KUMAR BAITHA,Independent,2887,3,2890,1.69,24
14,15,NOTA,None of the Above,5238,2,5240,3.06,24
0,1,Amjad Hussain Anwar,Rashtriya Lok Samta Party,9947,21,9968,5.77,25
1,2,Gaytri Devi,Bharatiya Janata Party,73343,77,73420,42.52,25
2,3,Ritu Kumar,Rashtriya Janata Dal,71614,237,71851,41.61,25
3,4,Abdul Shalik,Janata Congress,1491,1,1492,0.86,25
4,5,Chandan Kumar,Bhartiya Sablog Party,466,0,466,0.27,25
5,6,Nitish Kumar,Indian National League,346,0,346,0.2,25
6,7,Mohammad,Janta Dal Rashtravadi,727,0,727,0.42,25
7,8,Sarita Yadav,Jan Adhikar Party (Loktantrik),4160,4,4164,2.41,25
8,9,Surendra Panjiyar,Rashtriya Jansambhavna Party,1360,0,1360,0.79,25
9,10,Ganesh Sah,Independent,748,0,748,0.43,25
10,11,Chandrabhushan Kumar,Independent,951,0,951,0.55,25
11,12,Jay Kumar,Independent,1993,0,1993,1.15,25
12,13,Bhushan Prasad,Independent,1587,0,1587,0.92,25
13,14,NOTA,None of the Above,3589,1,3590,2.08,25
0,1,AMIT CHOUDHARI,Lok Jan Shakti Party,20161,120,20281,11.66,26
1,2,DILIP RAY,Janata Dal (United),67105,88,67193,38.63,26
2,3,SAYED ABU DOJANA,Rashtriya Janata Dal,57863,454,58317,33.53,26
3,4,ANUPAM KUMARI,Rashtriya Jan Jan Party,1801,3,1804,1.04,26
4,5,UMESH RAY,Bahujan Mukti Party,561,0,561,0.32,26
5,6,KRISHNA KUMAR JHA,"Proutist Bloc, India",406,0,406,0.23,26
6,7,GOBIND THAKUR,Bhartiya Party (Loktantrik),2177,2,2179,1.25,26
7,8,NAVAL KISHORE RAUT,Samajwadi Janata Dal Democratic,2327,3,2330,1.34,26
8,9,FEKAN MANDAL,Voters Party  International,1193,0,1193,0.69,26
9,10,MD. FAISAL AHAMAD,Indian National League,544,1,545,0.31,26
10,11,BHOGENDRA KUMAR,"Kushal Janta Party,",703,0,703,0.4,26
11,12,MANOJ PURBEY,Republican Party of India,1984,0,1984,1.14,26
12,13,SUNIL KUMAR,"Bhartiya Garibmazdoor Party,",1029,0,1029,0.59,26
13,14,KAMESHWAR THAKUR,Independent,3952,1,3953,2.27,26
14,15,PAPPU KUMAR CHOUDHARY,Independent,6725,9,6734,3.87,26
15,16,SONIYA DEVI,Independent,3105,0,3105,1.79,26
16,17,NOTA,None of the Above,1609,4,1613,0.93,26
0,1,MD. INTAKHAB ALAM,Lok Jan Shakti Party,6158,25,6183,3.48,27
1,2,MUKESH KUMAR YADAV,Rashtriya Janata Dal,70983,500,71483,40.21,27
2,3,DR. RANJU GEETA,Janata Dal (United),68658,121,68779,38.69,27
3,4,REKHA KUMARI,Rashtriya Lok Samta Party,11232,35,11267,6.34,27
4,5,SHAKIL AHAMAD,Nationalist Congress Party,471,0,471,0.26,27
5,6,MD. ANISUR RAHAMAN,Jan Adhikar Party (Loktantrik),1205,0,1205,0.68,27
6,7,NARESH SAH,Kisan Party of India,313,0,313,0.18,27
7,8,PRABODH KUMAR SHARMA,"Log Jan Party - Secular,",619,1,620,0.35,27
8,9,BHOLA SAHNI,Hindu Samaj Party,429,0,429,0.24,27
9,10,MOSADRE ALAM KURAISHI,Rashtriya Secular Majlis Party,715,0,715,0.4,27
10,11,MOHAMMAD AFTAB,Bhartiya Sablog Party,953,0,953,0.54,27
11,12,MD. SHOAIB KHAN,Indian National League,649,1,650,0.37,27
12,13,SARVESH THAKUR,Nationalist Janshakti Party,1411,0,1411,0.79,27
13,14,SAIYAD NEYAZ AHAMAD,Rashtriya Ulama Council,3191,0,3191,1.79,27
14,15,MD. IFTEKHAR,Independent,2077,0,2077,1.17,27
15,16,DEVENDRA JHA,Independent,1908,0,1908,1.07,27
16,17,NAGENDRA MISHRA,Independent,1132,0,1132,0.64,27
17,18,MUKESH KUMAR YADAV,Independent,1332,0,1332,0.75,27
18,19,RAMNIHORA SAH,Independent,1627,2,1629,0.92,27
19,20,SUBODH SAH,Independent,588,0,588,0.33,27
20,21,NOTA,None of the Above,1440,1,1441,0.81,27
0,1,MITHILESH KUMAR,Bharatiya Janata Party,90039,197,90236,49.9,28
1,2,RAKESH KUMAR TUNNA,Bahujan Samaj Party,2028,7,2035,1.13,28
2,3,SUNIL KUMAR,Rashtriya Janata Dal,78093,668,78761,43.55,28
3,4,AFTAB ANJUM,Swaraj India,965,0,965,0.53,28
4,5,KUMAR ABHIMANYU SRIVASTAVA,Samata Party,422,3,425,0.24,28
5,6,MANOJ KUMAR,Janta Dal Rashtravadi,696,0,696,0.38,28
6,7,VINOD SAH,Rashtriya Jansambhavna Party,912,2,914,0.51,28
7,8,SHAILENDRA PRASAD YADAV,Bahujan Mukti Party,407,1,408,0.23,28
8,9,SRINIVAS KUMAR,Bhartiya Sablog Party,766,6,772,0.43,28
9,10,SITARAM SINGH,"Proutist Bloc, India",577,0,577,0.32,28
10,11,KRISHNA KISHORE,Independent,1371,0,1371,0.76,28
11,12,RAJU KUMAR,Independent,703,0,703,0.39,28
12,13,NOTA,None of the Above,2977,2,2979,1.65,28
0,1,GUDDI DEVI,Lok Jan Shakti Party,15110,86,15196,9.96,29
1,2,PANKAJ KUMAR MISHRA,Janata Dal (United),73037,168,73205,47.96,29
2,3,MANGITA DEVI,Rashtriya Janata Dal,48189,387,48576,31.83,29
3,4,BRAJESH MAHTO,Janvadi Party(Socialist),2610,1,2611,1.71,29
4,5,LAL BABU ROY,Jan Adhikar Party (Loktantrik),2956,4,2960,1.94,29
5,6,VINAY KUMAR,The Plurals Party,919,0,919,0.6,29
6,7,SHRAVAN SAHNI,Rashtriya Jansambhavna Party,1045,2,1047,0.69,29
7,8,SONE LAL SAH,Hindustan Sampoorna Azad Party,1518,0,1518,0.99,29
8,9,LUV YADAV,Independent,2281,1,2282,1.5,29
9,10,NOTA,None of the Above,4307,3,4310,2.82,29
0,1,THAKUR DHARMENDRA SINGH,Rashtriya Lok Samta Party,18999,0,18999,13.66,30
1,2,MD NASIR AHMAD,Lok Jan Shakti Party,10687,0,10687,7.68,30
2,3,SHAMIM ALAM,Nationalist Congress Party,829,0,829,0.6,30
3,4,SANJAY KUMAR GUPTA,Rashtriya Janata Dal,49682,0,49682,35.71,30
4,5,SUNITA SINGH CHAUHAN,Janata Dal (United),35997,0,35997,25.87,30
5,6,AMAR SINGH,Rashtrawadi Janlok Party (Satya),977,0,977,0.7,30
6,7,BALRAM KUMAR,Bhartiya Party (Loktantrik),2205,0,2205,1.58,30
7,8,RAKESH KUMAR SINGH,The Plurals Party,912,0,912,0.66,30
8,9,SHRI RAM RAY,Republican Party of India (Athawale),1104,0,1104,0.79,30
9,10,SUBODH KUMAR RAY,Jan Adhikar Party (Loktantrik),2487,0,2487,1.79,30
10,11,PAPPU SAH,Independent,1017,0,1017,0.73,30
11,12,MAHANT NARENDRA DAS MAHATYAGI,Independent,3266,0,3266,2.35,30
12,13,LALBABU SAH,Independent,3149,0,3149,2.26,30
13,14,VANDANA KUMARI,Independent,2094,0,2094,1.51,30
14,15,SURESH BAITHA,Independent,1504,0,1504,1.08,30
15,16,NOTA,None of the Above,4218,0,4218,3.03,30
0,1,RAM NARESH PANDEY,Communist Party of India,42390,410,42800,25.58,31
1,2,VIKASH KUMAR MISHRA,Lok Jan Shakti Party,6154,23,6177,3.69,31
2,3,SANTOSH KUMAR SINGH,Rashtriya Lok Samta Party,6789,18,6807,4.07,31
3,4,SUDHANSHU SHEKHAR,Janata Dal (United),60205,188,60393,36.1,31
4,5,DEVAN MUKHIYA,Sanyukt Vikas Party,1665,0,1665,1,31
5,6,NAGINA PRASAD MAHTO,Swabhiman Party,580,2,582,0.35,31
6,7,MOHAMMAD YUNUS,Bahujan Mukti Party,585,5,590,0.35,31
7,8,SANJIV KAMAT,Bhartiya Lokmat Rashtrwadi Party,529,0,529,0.32,31
8,9,SANTOSH KUMAR JHA,Jan Adhikar Party (Loktantrik),2953,7,2960,1.77,31
9,10,AJAY BHAGAT,Independent,1859,6,1865,1.11,31
10,11,ARCHANA DEVI,Independent,1843,11,1854,1.11,31
11,12,DINESH KUMAR YADAV,Independent,1076,1,1077,0.64,31
12,13,MANGESH JHA,Independent,3035,4,3039,1.82,31
13,14,MANDAKINI CHAUDHARY,Independent,2922,10,2932,1.75,31
14,15,MD. SHABBIR,Independent,27368,131,27499,16.44,31
15,16,SHRAVAN KUMAR YADAV,Independent,3695,3,3698,2.21,31
16,17,SATISH KUMAR,Independent,1591,0,1591,0.95,31
17,18,NOTA,None of the Above,1240,2,1242,0.74,31
0,1,NAGENDRA PRASAD YADAV,Bahujan Samaj Party,1852,5,1857,1.19,32
1,2,BHAWANA JHA,Indian National Congress,45819,391,46210,29.67,32
2,3,VINOD NARAYAN JHA,Bharatiya Janata Party,78723,139,78862,50.63,32
3,4,ANURADHA SINGH,The Plurals Party,1838,3,1841,1.18,32
4,5,NUTAN DEVI,Republican Party of India (Athawale),606,0,606,0.39,32
5,6,ABUBAKAR RAHMANI,Independent,752,0,752,0.48,32
6,7,AMAR NATH,Independent,521,1,522,0.34,32
7,8,CHANDAN KUMAR,Independent,566,3,569,0.37,32
8,9,NIRAJ KUMAR JHA,Independent,3864,14,3878,2.49,32
9,10,MITHILESH CHANDRA JHA,Independent,557,0,557,0.36,32
10,11,RAJESH KUMAR YADAV,Independent,9525,47,9572,6.14,32
11,12,RUPESH KUMAR,Independent,909,1,910,0.58,32
12,13,LALAN KISHOR JHA,Independent,2299,0,2299,1.48,32
13,14,VINOD SHANKAR JHA,Independent,3559,0,3559,2.28,32
14,15,VINODANAND KAMAT,Independent,2128,0,2128,1.37,32
15,16,NOTA,None of the Above,1647,1,1648,1.06,32
0,1,ARUN SHANKAR PRASAD,Bharatiya Janata Party,82870,291,83161,44.51,33
1,2,SITARAM YADAV,Rashtriya Janata Dal,59833,639,60472,32.37,33
2,3,KUMAR CHAITANY,The Plurals Party,1003,1,1004,0.54,33
3,4,CHANDRAKETU NARAYAN YADAV,Janta Dal Rashtravadi,661,0,661,0.35,33
4,5,DINESH PRASAD SINGH,Janshakti Vikas Party (Democratic),681,1,682,0.37,33
5,6,BABLU  GUPTA,Republican Party of India (Athawale),773,0,773,0.41,33
6,7,BRAJ KISHOR YADAV,Jan Adhikar Party (Loktantrik),13529,60,13589,7.27,33
7,8,RAJDEV DAS,Bhartiya Sablog Party,672,0,672,0.36,33
8,9,RAM KUMAR RAM,Bahujan Mukti Party,592,1,593,0.32,33
9,10,RAM SUFAL YADAV,Jan Mithila Vikas Party,1491,0,1491,0.8,33
10,11,RITESH KUMAR MANDAL,Prabal Bharat Party,759,0,759,0.41,33
11,12,VIRENDRA KUMAR YADAV,Samajwadi Janata Dal Democratic,2770,12,2782,1.49,33
12,13,SYED HASSANUL HAQUE,Aazad Samaj Party (Kanshi Ram),1294,4,1298,0.69,33
13,14,HARI BHUSHAN KUMAR,"Log Jan Party - Secular,",1010,2,1012,0.54,33
14,15,AMIT KUMAR MAHTO,Independent,2173,1,2174,1.16,33
15,16,AMBIKA PD SINGH,Independent,8314,41,8355,4.47,33
16,17,DILIP KUWAR,Independent,3682,7,3689,1.97,33
17,18,NARESH KUMAR SINGH,Independent,1184,4,1188,0.64,33
18,19,PURUSHOTTAM PRASAD GUPTA,Independent,383,0,383,0.2,33
19,20,PRAMILA DEVI,Independent,269,0,269,0.14,33
20,21,BRAJESH RAUT,Independent,273,0,273,0.15,33
21,22,RAMNARAYAN THAKUR,Independent,364,0,364,0.19,33
22,23,NOTA,None of the Above,1190,3,1193,0.64,33
0,1,AMAR NATH PRASAD,Lok Jan Shakti Party,9793,25,9818,5.13,34
1,2,UMAKANT YADAV,Rashtriya Janata Dal,65111,768,65879,34.39,34
2,3,MAHENDRA PRASAD SINGH,Rashtriya Lok Samta Party,11691,68,11759,6.14,34
3,4,MINA KUMARI,Janata Dal (United),77133,234,77367,40.39,34
4,5,ANIL KUMAR YADAV,Republican Party of India (Athawale),1634,0,1634,0.85,34
5,6,MANOJ JHA,Samata Party,2936,5,2941,1.54,34
6,7,RAJ KUMAR SINGH,Jan Adhikar Party (Loktantrik),1503,1,1504,0.79,34
7,8,RAMA SAHNI,Bhartiya Chetna Party,915,0,915,0.48,34
8,9,VIDYA SAGAR MANDAL,Jago Hindustan Party,1951,3,1954,1.02,34
9,10,VISHWANATH ROY,Bhartiya Rashtriya Dal,2242,0,2242,1.17,34
10,11,SHALINI KUMARI,The Plurals Party,3406,7,3413,1.78,34
11,12,SHIV NANDAN MANDAL,Voters Party  International,3653,0,3653,1.91,34
12,13,MAHA NARAYAN ROY,Independent,3490,2,3492,1.82,34
13,14,NOTA,None of the Above,4983,5,4988,2.6,34
0,1,TAUKIR,Nationalist Congress Party,1516,2,1518,0.85,35
1,2,Da. FAIYAZ AHMAD,Rashtriya Janata Dal,75829,504,76333,42.7,35
2,3,"HARIBHUSHAN THAKUR ""BACHOL""",Bharatiya Janata Party,86298,276,86574,48.43,35
3,4,ABADHESH KUMAR,Jantantrik Lokhit Party,1463,0,1463,0.82,35
4,5,MD AUSAF,Samajwadi Janata Dal Democratic,771,4,775,0.43,35
5,6,PUSHPAM PRIYA,The Plurals Party,1509,12,1521,0.85,35
6,7,ARVIND KUMAR MISHRA,Independent,263,0,263,0.15,35
7,8,ASHOK KUMAR ROY,Independent,351,0,351,0.2,35
8,9,INDRAJEET MAHTO,Independent,962,2,964,0.54,35
9,10,BHARAT PASWAN,Independent,613,4,617,0.35,35
10,11,MANISH KUMAR,Independent,876,2,878,0.49,35
11,12,MAHESHWAR PRASAD CHAUDHARY,Independent,2410,1,2411,1.35,35
12,13,RAJ KUMAR MUKHIYA,Independent,2172,0,2172,1.21,35
13,14,NOTA,None of the Above,2928,1,2929,1.64,35
0,1,ARVIND KUMAR PURBEY,Lok Jan Shakti Party,15775,43,15818,8.43,36
1,2,SAMIR KUMAR MAHASETH,Rashtriya Janata Dal,70727,605,71332,38,36
2,3,ANPURNA DEVI,Bhartiya Chetna Party,1728,10,1738,0.93,36
3,4,AMANULLAH KHAN,Samajwadi Janata Dal Democratic,7307,37,7344,3.91,36
4,5,DINESH MANDAL,Republican Party of India (Athawale),2057,0,2057,1.1,36
5,6,MADHU BALA GIRI,The Plurals Party,2791,13,2804,1.49,36
6,7,SHANKAR MAHASETH,Shiv Sena,1525,0,1525,0.81,36
7,8,SUMAN KUMAR MAHASETH,Vikassheel Insaan Party,64237,281,64518,34.37,36
8,9,ANITA KUMARI ALIAS ANITA JHA,Independent,1993,8,2001,1.07,36
9,10,MIHIR KUMAR JHA 'MAHADEO',Independent,4858,8,4866,2.59,36
10,11,MOHAMMAD NESAR AHMAD RAZVI,Independent,1305,3,1308,0.7,36
11,12,RAMDEO MAHTO,Independent,8214,33,8247,4.39,36
12,13,NOTA,None of the Above,4168,13,4181,2.23,36
0,1,Dr. Ramprit Paswan,Bharatiya Janata Party,89239,220,89459,51.42,37
1,2,Ramawatar Paswan,Rashtriya Janata Dal,69851,487,70338,40.43,37
2,3,Arun Kumar Mandal,Jago Hindustan Party,1596,4,1600,0.92,37
3,4,Gopal Choupal,Bhartiya Chetna Party,687,1,688,0.4,37
4,5,Channe Saday,Janhit Kisan Party,599,0,599,0.34,37
5,6,Raja Ram Chaupal,Voters Party  International,1612,0,1612,0.93,37
6,7,Shiv Shankar Paswan,Samajwadi Janata Dal Democratic,721,5,726,0.42,37
7,8,Santosh Kumar Suman,The Plurals Party,1261,6,1267,0.73,37
8,9,Jay Bansh Kumar Ram,Independent,1368,0,1368,0.79,37
9,10,Rakesh Kumar,Independent,2017,0,2017,1.16,37
10,11,NOTA,None of the Above,4296,7,4303,2.47,37
0,1,NITISH MISHRA,Bharatiya Janata Party,94641,213,94854,52.47,38
1,2,BIRENDRA KUMAR CHOUDHARY,Rashtriya Lok Samta Party,3246,16,3262,1.8,38
2,3,RAM NARAYAN YADAV,Communist Party of India,52780,286,53066,29.36,38
3,4,OM PRAKASH PODDAR,Janmat Party,1200,0,1200,0.66,38
4,5,RAJ KUMAR SADAY,Bahujan Mukti Party,629,3,632,0.35,38
5,6,RAM SHANKAR RAUT,Satya Bahumat Party,256,0,256,0.14,38
6,7,RAMCHANDRA RAY,Janhit Kisan Party,399,0,399,0.22,38
7,8,BAIDEHI KANTA SHARAN,Akhil Bhartiya Mithila Party,746,1,747,0.41,38
8,9,SANJEEV KUMAR SUMAN,The Plurals Party,600,0,600,0.33,38
9,10,SADANAND SUMAN,Jan Adhikar Party (Loktantrik),840,2,842,0.47,38
10,11,ABDUL IRFAN,Independent,376,1,377,0.21,38
11,12,ABHAY KANT MISHRA,Independent,1374,1,1375,0.76,38
12,13,GANGA PRASAD GANGOTRI,Independent,8642,16,8658,4.79,38
13,14,GANPATI JHA,Independent,2670,1,2671,1.48,38
14,15,BANDANA DEVI,Independent,1255,0,1255,0.69,38
15,16,MADAN KUMAR MAHTO,Independent,5683,0,5683,3.14,38
16,17,RAKESH KUMAR YADAV,Independent,2784,4,2788,1.54,38
17,18,LAKSHMAN PRASAD YADAV,Independent,600,1,601,0.33,38
18,19,NOTA,None of the Above,1493,3,1496,0.83,38
0,1,KRIPANATH PATHAK,Indian National Congress,63721,429,64150,35.24,39
1,2,BINOD KUMAR SINGH,Lok Jan Shakti Party,10057,31,10088,5.54,39
2,3,SHEELA KUMARI,Janata Dal (United),74919,197,75116,41.26,39
3,4,ASHOK SINGH,Nationalist Janshakti Party,1556,0,1556,0.85,39
4,5,GANESH YADAV,Voters Party  International,680,2,682,0.37,39
5,6,GAURI SHANKAR YADAV,Jan Adhikar Party (Loktantrik),4903,13,4916,2.7,39
6,7,PARWEZ ALAM,Peace Party,1504,0,1504,0.83,39
7,8,BRAJESH KUMAR KUNWAR,The Plurals Party,1275,3,1278,0.7,39
8,9,RATNESH KUMAR SAHU,Peoples Party of India (Democratic),964,3,967,0.53,39
9,10,RAM KUMAR YADAV,Samajwadi Janata Dal Democratic,2820,11,2831,1.56,39
10,11,GULAJAR DEVI,Independent,4920,19,4939,2.71,39
11,12,SHRIMATI REKHA RANJAN YADAV,Independent,964,0,964,0.53,39
12,13,VIJAY KUMAR,Independent,2616,1,2617,1.44,39
13,14,SANJAY KUMAR SINGH URF SAHIL KUMAR SINGH,Independent,4448,0,4448,2.44,39
14,15,HRIDAY NARAYAN KAMAT,Independent,2104,1,2105,1.16,39
15,16,NOTA,None of the Above,3888,6,3894,2.14,39
0,1,PRAMOD KUMAR PRIYEDARSHI,Lok Jan Shakti Party,30393,101,30494,14.59,40
1,2,BHARAT BHUSHAN MANDAL,Rashtriya Janata Dal,77759,764,78523,37.57,40
2,3,LAKSHMESHWAR RAY,Janata Dal (United),68288,158,68446,32.75,40
3,4,ALOK KUMAR YADAV,Samajwadi Janata Dal Democratic,4916,14,4930,2.36,40
4,5,INDU DEVI,Rashtriya Janwadi Party (Socialist),782,0,782,0.37,40
5,6,KUMARI MALVIKA,Bhartiya Chetna Party,810,0,810,0.39,40
6,7,DEVA SHANKAR ARYA,Bhartiya Lokmat Rashtrwadi Party,423,0,423,0.2,40
7,8,BHOLA PASWAN,"Proutist Bloc, India",1666,1,1667,0.8,40
8,9,RANJEET KUMAR YADAV,Satya Bahumat Party,848,0,848,0.41,40
9,10,RAM KUMAR MANDAL,Voters Party  International,954,1,955,0.46,40
10,11,LALIT KUMAR MAHTO,Jan Adhikar Party (Loktantrik),2457,3,2460,1.18,40
11,12,LALIT MANDAL,Jago Hindustan Party,1352,2,1354,0.65,40
12,13,INDRADEV JEE,Independent,1806,0,1806,0.86,40
13,14,DINESH GUPTA,Independent,6310,9,6319,3.02,40
14,15,BALESHWAR GURMAITA,Independent,4702,1,4703,2.25,40
15,16,NOTA,None of the Above,4484,2,4486,2.15,40
0,1,ANIRUDDHA PRASAD YADAV,Janata Dal (United),92250,189,92439,49.33,41
1,2,ARJUN PRASAD MEHTA,Rashtriya Lok Samta Party,12661,64,12725,6.79,41
2,3,GAUTAM KUMAR,Lok Jan Shakti Party,6313,32,6345,3.39,41
3,4,YADUBANSH KUMAR YADAV,Rashtriya Janata Dal,48055,462,48517,25.89,41
4,5,SHAMBHU CHOUDHARY,Nationalist Congress Party,932,1,933,0.5,41
5,6,KRISHNAAVATAR SINGH,Bhartiya Chetna Party,770,2,772,0.41,41
6,7,GOSAI MANDAL,Jantantrik Vikas Party,590,1,591,0.32,41
7,8,DHIRAJ KUMAR,The Plurals Party,1150,3,1153,0.62,41
8,9,PAPPU YADAV,Proutist Sarva Samaj,689,5,694,0.37,41
9,10,RAVINDRA PRASAD SAH,Rashtriya Secular Majlis Party,986,2,988,0.53,41
10,11,RAMDEV SHARMA,Peoples Party of India (Democratic),972,0,972,0.52,41
11,12,VIJAY KUMAR YADAV,Jan Adhikar Party (Loktantrik),8843,43,8886,4.74,41
12,13,AMAN KUMAR SAMAJSEVI,Independent,3175,0,3175,1.69,41
13,14,GYANSHANKER CHOUDHARY,Independent,2030,1,2031,1.08,41
14,15,MANOJ KUMAR,Independent,2392,0,2392,1.28,41
15,16,NOTA,None of the Above,4779,2,4781,2.55,41
0,1,OM PRAKASH ROY,Nationalist Congress Party,1924,3,1927,1.06,42
1,2,RAMBILASH KAMAT,Janata Dal (United),82267,121,82388,45.35,42
2,3,VISHWA MOHAN KUMAR,Rashtriya Janata Dal,62551,592,63143,34.76,42
3,4,SHAKUNTALA PRASAD,Lok Jan Shakti Party,5644,16,5660,3.12,42
4,5,AMLESH KUMAR JHA,All India Forward Bloc,772,2,774,0.43,42
5,6,ARJUN SHARMA,Republican Party of India (Rashtriya),661,2,663,0.36,42
6,7,ASIF KAMAL,Rashtrawadi Minority Party,1096,2,1098,0.6,42
7,8,GAUTAM KUMAR,Janta Dal Rashtravadi,1180,2,1182,0.65,42
8,9,Manoj Kumar Mandal,Prabal Bharat Party,1338,1,1339,0.74,42
9,10,MAHAN KUMAR,Sanyukt Kisan Vikas Party,1043,2,1045,0.58,42
10,11,MAHENDRA SAH,Jan Adhikar Party (Loktantrik),3751,19,3770,2.08,42
11,12,RANJIT KUMAR PASWAN,Samata Party,739,2,741,0.41,42
12,13,RANJEET PASWAN,Bharat Nirman Party,1924,3,1927,1.06,42
13,14,RAJU KUMAR,Proutist Sarva Samaj,3562,1,3563,1.96,42
14,15,RAJESH KUMAR,The Plurals Party,2922,1,2923,1.61,42
15,16,AMIT KUMAR SINGH,Independent,2507,1,2508,1.38,42
16,17,CHANDRA KISHOR YADAV,Independent,1333,1,1334,0.73,42
17,18,MAHENDRA PRASAD CHOUDHARY,Independent,3055,0,3055,1.68,42
18,19,NOTA,None of the Above,2631,2,2633,1.45,42
0,1,PRABHASH CHANDRA MANDAL,Lok Jan Shakti Party,8467,48,8515,4.96,43
1,2,BIJENDRA PRASAD YADAV,Janata Dal (United),85921,253,86174,50.2,43
2,3,MINNATULLAH RAHMANI,Indian National Congress,57675,400,58075,33.83,43
3,4,UPENDRA SHARMA,Jantantrik Vikas Party,1476,1,1477,0.86,43
4,5,PANKAJ KUMAR MANDAL,Peoples Party of India (Democratic),799,3,802,0.47,43
5,6,BHOGI MANDAL,Rashtravadi Janata Party,727,1,728,0.42,43
6,7,MRITUNJAY KUMAR,Janata Dal  (Secular),1168,1,1169,0.68,43
7,8,RAJESH KUMAR,Voters Party  International,982,1,983,0.57,43
8,9,SHIV NATH PRASAD GUPTA,Rashtriya Samaj Dal (R),1190,3,1193,0.7,43
9,10,Suresh Kumar Azad,Jai Hind Party,2616,0,2616,1.52,43
10,11,ANIL KUMAR SINGH,Independent,5724,12,5736,3.34,43
11,12,NOTA,None of the Above,4179,1,4180,2.44,43
0,1,RENU LATA BHARTI,Lok Jan Shakti Party,5178,16,5194,2.93,44
1,2,VEENA BHARTI,Janata Dal (United),79262,196,79458,44.84,44
2,3,SANTOSH KUMAR,Rashtriya Janata Dal,75860,567,76427,43.13,44
3,4,JAY PRAKASH PASWAN,Jantantrik Vikas Party,1571,0,1571,0.89,44
4,5,JITENDRA RAM,Republican Party of India (Rashtriya),883,3,886,0.5,44
5,6,RANJAN KUMAR SARDAR,Jai Maha Bharath Party,2625,4,2629,1.48,44
6,7,RABINDRA KUMAR CHAUPAL,Vanchit Bahujan Aaghadi,3001,1,3002,1.69,44
7,8,SHANKAR KUMAR SUMAN,Lokpriya Samaj Party,2370,2,2372,1.34,44
8,9,SIKENDRA PASWAN,Mazdoor Kirayedar Vikas Party,2120,3,2123,1.2,44
9,10,NOTA,None of the Above,3544,2,3546,2,44
0,1,NEERAJ KUMAR SINGH,Bharatiya Janata Party,93570,185,93755,46.39,45
1,2,MOHAMMAD MATIN ANSARI,Bahujan Samaj Party,1755,6,1761,0.87,45
2,3,DR. RANJEET KUMAR JHA,Nationalist Congress Party,948,3,951,0.47,45
3,4,VIPIN KUMAR SINGH,Rashtriya Janata Dal,72712,408,73120,36.18,45
4,5,ALAM,All India Majlis-E-Ittehadul Muslimeen,1984,6,1990,0.98,45
5,6,BHASKAR KUMAR MISHRA,The Plurals Party,435,0,435,0.22,45
6,7,MANOJ KUMAR MANDAL,Jantantrik Vikas Party,432,1,433,0.21,45
7,8,MD. MUSTAK,Bhartiya Jantantrik Janata Dal,362,0,362,0.18,45
8,9,MOHAMMAD ISA SYED,All India Minorities Front,462,0,462,0.23,45
9,10,SANJEEV MISHRA,Jan Adhikar Party (Loktantrik),3653,6,3659,1.81,45
10,11,ARUN KUMAR AZAD,Independent,3515,11,3526,1.74,45
11,12,KRISHNA MOHAN YADAV,Independent,924,2,926,0.46,45
12,13,DAYANAND MISHRA,Independent,2088,0,2088,1.03,45
13,14,DEEPAK KUMAR MISHRA,Independent,1467,2,1469,0.73,45
14,15,DURGANAND SINGH,Independent,1465,4,1469,0.73,45
15,16,DEO NARAYAN SADA,Independent,4274,0,4274,2.11,45
16,17,NASIBLAL SADA,Independent,3287,0,3287,1.63,45
17,18,NIRANJAN PRASAD GUPTA,Independent,1715,0,1715,0.85,45
18,19,BABAN SINGH,Independent,2513,18,2531,1.25,45
19,20,BHOLA PASWAN,Independent,1657,2,1659,0.82,45
20,21,MEHBOOB ALAM,Independent,535,0,535,0.26,45
21,22,VIPIN KUMAR YADAV,Independent,459,3,462,0.23,45
22,23,NOTA,None of the Above,1214,5,1219,0.6,45
0,1,ANIL KUMAR YADAV,Rashtriya Janata Dal,69679,108,69787,34.79,46
1,2,CHANDRESH KUMAR,Nationalist Congress Party,1677,1,1678,0.84,46
2,3,JAI PRAKASH YADAV,Bharatiya Janata Party,98360,37,98397,49.06,46
3,4,ANANT KUMAR RAY,Bahujan Mukti Party,1948,2,1950,0.97,46
4,5,GUNJA DEVI,Shiv Sena,544,0,544,0.27,46
5,6,NISHANT KR JHA,The Plurals Party,511,0,511,0.25,46
6,7,PAPPU KUMAR SINGH,Rashtrawadi Janlok Party (Satya),379,0,379,0.19,46
7,8,PRINCE VICTOR,Jan Adhikar Party (Loktantrik),3992,1,3993,1.99,46
8,9,MD. MUKHTAR ALAM,Bhartiya Jantantrik Janata Dal,457,0,457,0.23,46
9,10,MOHAMMAD ABUBAKAR,All India Minorities Front,340,0,340,0.17,46
10,11,RAJ KUMAR RISHIDEV,Apna Adhikar Party,522,3,525,0.26,46
11,12,LOCHAN KAMET,Bhartiya Lokmat Rashtrwadi Party,481,0,481,0.24,46
12,13,SADHAN KUMAR YADAV,Janshakti Vikas Party (Democratic),932,0,932,0.46,46
13,14,HADIS,All India Majlis-E-Ittehadul Muslimeen,5493,2,5495,2.74,46
14,15,HARUN,Janta Dal Rashtravadi,2863,0,2863,1.43,46
15,16,AKHILESH KUMAR,Independent,4891,0,4891,2.44,46
16,17,ALOK KUMAR,Independent,2774,0,2774,1.38,46
17,18,NAND LAL PASWAN,Independent,817,0,817,0.41,46
18,19,PRASENJEET KRISHNA,Independent,2287,1,2288,1.14,46
19,20,SHASHI BHUSHAN YADAV,Independent,598,0,598,0.3,46
20,21,NOTA,None of the Above,874,0,874,0.44,46
0,1,ACHMIT RISHIDEV,Janata Dal (United),81874,27,81901,44.12,47
1,2,AVINASH MANGLAM,Rashtriya Janata Dal,79479,118,79597,42.88,47
2,3,PARMANAND RISHIDEO,Lok Jan Shakti Party,5034,4,5038,2.71,47
3,4,FUDDAN PASWAN,Rashtriya Jansambhavna Party,1349,0,1349,0.73,47
4,5,BALKRISHN RAJ CHOUDHARY,Apna Adhikar Party,565,0,565,0.3,47
5,6,RENU KUMARI,"Aam Janmat Party,",745,0,745,0.4,47
6,7,ROSHAN DEVI,All India Majlis-E-Ittehadul Muslimeen,2411,1,2412,1.3,47
7,8,LAKSHMI RISHI,Bharatiya Momin Front,555,0,555,0.3,47
8,9,VIRENDER RISHIDEO,Bhartiya Lokmat Rashtrwadi Party,569,0,569,0.31,47
9,10,SUNIL PASWAN,Jan Adhikar Party (Loktantrik),2920,2,2922,1.57,47
10,11,KALO PASWAN,Independent,1943,0,1943,1.05,47
11,12,SHANKAR BRAHAMCHARI,Independent,2466,1,2467,1.33,47
12,13,NOTA,None of the Above,5576,1,5577,3,47
0,1,ZAKIR HUSSAIN KHAN,Indian National Congress,82381,129,82510,39.98,48
1,2,RAJA RAMAN BHASKAR,Bahujan Samaj Party,5813,5,5818,2.82,48
2,3,VIDYA SAGAR KESHARI,Bharatiya Janata Party,102130,82,102212,49.53,48
3,4,AKHLAQUR RAHMAN,Jan Adhikar Party (Loktantrik),2203,4,2207,1.07,48
4,5,ASHOK MISHRA,Samajwadi Janata Dal Democratic,349,0,349,0.17,48
5,6,CHANDAN KUMAR MANDAL,Rashtriya Jansambhavna Party,485,0,485,0.24,48
6,7,DEVESH KUMAR THAKUR,Vanchit Samaj Party,298,0,298,0.14,48
7,8,NASIR,Bhartiya Party (Loktantrik),243,0,243,0.12,48
8,9,MADAN KUMAR,Apna Adhikar Party,319,0,319,0.15,48
9,10,RAM KUMAR BHAGAT,Republican Party of India (Athawale),416,0,416,0.2,48
10,11,RUPESH RAJ,The Plurals Party,675,1,676,0.33,48
11,12,MD. ARIF,Independent,1036,0,1036,0.5,48
12,13,PRADEEP KUMAR DEO,Independent,6440,12,6452,3.13,48
13,14,NOTA,None of the Above,3350,1,3351,1.62,48
0,1,ABIDUR RAHMAN,Indian National Congress,102855,199,103054,54.84,49
1,2,CHANDRA SHEKHAR SINGH BABAN,Lok Jan Shakti Party,8172,31,8203,4.37,49
2,3,SHAGUFTA AZIM,Janata Dal (United),55027,91,55118,29.33,49
3,4,AMIT ANAND JHA,The Plurals Party,1801,1,1802,0.96,49
4,5,MD. IMTIYAZ,Rashtriya Jansambhavna Party,522,0,522,0.28,49
5,6,QAMRUL HODA,SOCIAL DEMOCRATIC PARTY OF INDIA,716,1,717,0.38,49
6,7,MD. MOUSTAQ ALAM,Apna Kisan Party,751,0,751,0.4,49
7,8,MD. RASHID ANWER,All India Majlis-E-Ittehadul Muslimeen,8922,2,8924,4.75,49
8,9,ASHISH KUMAR BHARDWAJ,Independent,1011,1,1012,0.54,49
9,10,JAWWAD ALAM,Independent,644,1,645,0.34,49
10,11,BECHAN PASWAN,Independent,1455,1,1456,0.77,49
11,12,RAJA BABU,Independent,1279,0,1279,0.68,49
12,13,NOTA,None of the Above,4423,2,4425,2.35,49
0,1,MOHD MOBINUL HAQUE,Nationalist Congress Party,1243,0,1243,0.71,50
1,2,RANJIT YADAV,Bharatiya Janata Party,48892,41,48933,28.1,50
2,3,SARFARAZ ALAM,Rashtriya Janata Dal,51980,233,52213,29.98,50
3,4,AFAQUE ANWAR,Rashtriya Secular Majlis Party,1386,2,1388,0.8,50
4,5,MANAWWAR ALI,Janta Dal Rashtravadi,956,0,956,0.55,50
5,6,RAM RATAN YADAV,Angika Samaj Party,919,0,919,0.53,50
6,7,MD SHABBIR AHMAD,SOCIAL DEMOCRATIC PARTY OF INDIA,2349,1,2350,1.35,50
7,8,SHAHNAWAZ,All India Majlis-E-Ittehadul Muslimeen,59523,73,59596,34.22,50
8,9,SABA PERWEEN,Independent,3695,1,3696,2.12,50
9,10,NOTA,None of the Above,2842,2,2844,1.63,50
0,1,VIJAY KUMAR MANDAL,Bharatiya Janata Party,84072,56,84128,46.92,51
1,2,SHATRUGHAN PRASAD SUMAN,Rashtriya Janata Dal,70356,162,70518,39.33,51
2,3,MD JAINUDDIN ROY,Bhartiya Lokmat Rashtrwadi Party,1180,0,1180,0.66,51
3,4,DINESH KUMAR YADAV,Republican Party of India (Athawale),1306,0,1306,0.73,51
4,5,LUKMAN,Vikassheel Insaan Party,229,0,229,0.13,51
5,6,MD ABRAR ALAM,Independent,357,0,357,0.2,51
6,7,ABHISHEK ANAND,Independent,6832,7,6839,3.81,51
7,8,UMESH KUMAR MANDAL,Independent,432,1,433,0.24,51
8,9,MD. QUAMRUZZAMA,Independent,4513,2,4515,2.52,51
9,10,PRAKASH SHARMA,Independent,418,0,418,0.23,51
10,11,BUDHIR KUMAR SARDAR,Independent,1003,0,1003,0.56,51
11,12,RAJESH KUMAR MISHRA,Independent,2959,2,2961,1.65,51
12,13,RAJESH KUMAR SINGH,Independent,1603,2,1605,0.9,51
13,14,RUBINA KUMARI,Independent,1481,0,1481,0.83,51
14,15,NOTA,None of the Above,2310,0,2310,1.29,51
0,1,Md. Tauseef Alam,Indian National Congress,29818,386,30204,17.51,52
1,2,NAZIM AHMAD,Nationalist Congress Party,1175,1,1176,0.68,52
2,3,Chandan Kumar Yadav,Shiv Sena,2647,0,2647,1.53,52
3,4,MOHAMMAD ANZAR NAYEEMI,All India Majlis-E-Ittehadul Muslimeen,85472,383,85855,49.77,52
4,5,Mohammad Mansoor Alam,Jan Adhikar Party (Loktantrik),2192,2,2194,1.27,52
5,6,Mohammad Musfik Ala,Bahujan Maha Party,1825,0,1825,1.06,52
6,7,LAKHAN LAL PANDIT,Vikassheel Insaan Party,40494,146,40640,23.56,52
7,8,SAMBHU PRASAD DAS,Independent,1528,1,1529,0.89,52
8,9,Hari Mohan Singh,Independent,1690,1,1691,0.98,52
9,10,NOTA,None of the Above,4729,0,4729,2.74,52
0,1,Md. Kalimuddin,Lok Jan Shakti Party,2480,10,2490,1.29,53
1,2,Md. Naushad Alam,Janata Dal (United),21921,161,22082,11.46,53
2,3,Saud Alam,Rashtriya Janata Dal,79354,555,79909,41.48,53
3,4,Devbret Kumar Ganesh,Jan Adhikar Party (Loktantrik),2474,5,2479,1.29,53
4,5,Navin Kumar Mallah,Shiv Sena,1634,2,1636,0.85,53
5,6,Mahbub Alam,All India Majlis-E-Ittehadul Muslimeen,18890,35,18925,9.82,53
6,7,Shahanavaj,Rashtriya Secular Majlis Party,1919,0,1919,1,53
7,8,Gopal Kumar Agarwal,Independent,55845,177,56022,29.08,53
8,9,Shakir Alam,Independent,2700,1,2701,1.4,53
9,10,MD. Safir Alam,Independent,1489,0,1489,0.77,53
10,11,NOTA,None of the Above,2975,1,2976,1.54,53
0,1,IJAHARUL HUSAIN,Indian National Congress,60599,479,61078,34.2,54
1,2,Sweety Singh,Bharatiya Janata Party,59378,319,59697,33.42,54
2,3,ANIL SINGH,Bhartiya Party (Loktantrik),1372,0,1372,0.77,54
3,4,MD. QAMRUL HODA,All India Majlis-E-Ittehadul Muslimeen,41727,177,41904,23.46,54
4,5,TAJAMUDDIN,Bharat Jago Janta Party,461,0,461,0.26,54
5,6,PERWEZ ALAM,Rashtriya Ulama Council,461,0,461,0.26,54
6,7,FIROZ ALAM,All India Forward Bloc,477,2,479,0.27,54
7,8,Maksood Alam,Vikassheel Insaan Party,269,0,269,0.15,54
8,9,MOHAMMAD ZAHID ALAM,Loktantrik Janta Dal,425,2,427,0.24,54
9,10,MOHAMMAD MEHBOOBUR RAHMAN,SOCIAL DEMOCRATIC PARTY OF INDIA,419,1,420,0.24,54
10,11,Shambhu Kumar Yadav,Rashtriya Unnati Party,402,2,404,0.23,54
11,12,Shivnath Malik,Shiv Sena,624,1,625,0.35,54
12,13,Abdul Ghafoor,Independent,977,1,978,0.55,54
13,14,IJEKAL HASADA,Independent,993,0,993,0.56,54
14,15,CHHOTE LAL MAHTO,Independent,997,1,998,0.56,54
15,16,TAILA KISHKU,Independent,1552,0,1552,0.87,54
16,17,TASIR UDDIN,Independent,2066,3,2069,1.16,54
17,18,Mohan Singh,Independent,1418,1,1419,0.79,54
18,19,RAMNATH SHARMA,Independent,1258,2,1260,0.71,54
19,20,SHILPI KUMARI,Independent,706,1,707,0.4,54
20,21,NOTA,None of the Above,1034,3,1037,0.58,54
0,1,MUJAHID ALAM,Janata Dal (United),43476,274,43750,27.08,55
1,2,MOHAMMAD SHAHID ALAM,Rashtriya Janata Dal,25740,394,26134,16.18,55
2,3,HABIBUR RAHMAN,Lok Jan Shakti Party,1606,0,1606,0.99,55
3,4,MUHAMMED IZHAR ASFI,All India Majlis-E-Ittehadul Muslimeen,79548,345,79893,49.45,55
4,5,RAVI KUMAR ROY,Hindu Samaj Party,826,0,826,0.51,55
5,6,SABIR ALAM,Jan Adhikar Party (Loktantrik),650,2,652,0.4,55
6,7,AMAR PASWAN,Independent,396,1,397,0.25,55
7,8,AVADH DAS,Independent,381,1,382,0.24,55
8,9,JUNAS MARANDI,Independent,801,0,801,0.5,55
9,10,DAYANAND MANDAL,Independent,1946,1,1947,1.21,55
10,11,MD. NASIK NADIR,Independent,907,2,909,0.56,55
11,12,BABLU BASKI,Independent,1318,0,1318,0.82,55
12,13,NOTA,None of the Above,2953,0,2953,1.83,55
0,1,ABDUL JALIL MASTAN,Indian National Congress,31475,388,31863,17.26,56
1,2,UPENDRA YADAV,Nationalist Congress Party,675,3,678,0.37,56
2,3,MANOJ KUMAR NISHAD,Lok Jan Shakti Party,914,5,919,0.5,56
3,4,SABA ZAFAR,Janata Dal (United),41812,132,41944,22.72,56
4,5,AKHTARUL IMAN,All India Majlis-E-Ittehadul Muslimeen,94108,351,94459,51.17,56
5,6,MD AKHTER HUSEN,Jantantrik Vikas Party,1638,0,1638,0.89,56
6,7,GULAM MOHAMMAD,Peace Party,1213,4,1217,0.66,56
7,8,JHALKESHWAR KUMAR GUPTA,Jan Adhikar Party (Loktantrik),3156,8,3164,1.71,56
8,9,MATIUR RAHMAN,Janta Dal Rashtravadi,1670,3,1673,0.91,56
9,10,ABDUL RAJJAK ALIAS KALA BABA,Independent,908,1,909,0.49,56
10,11,MD MAZHARUL BARI,Independent,1182,2,1184,0.64,56
11,12,NOTA,None of the Above,4950,8,4958,2.69,56
0,1,ABDUS SUBHAN,Rashtriya Janata Dal,37918,336,38254,21.4,57
1,2,MD FIROZ ALAM,Nationalist Congress Party,1120,1,1121,0.63,57
2,3,VINOD KUMAR,Bharatiya Janata Party,51850,193,52043,29.11,57
3,4,ISRAIL AZAD,Jan Adhikar Party (Loktantrik),2399,5,2404,1.34,57
4,5,MOHAMMED NAUSHAD ALAM,All India Minorities Front,530,1,531,0.3,57
5,6,MOHAMMED SHAHNAWAZ ALAM,All India Majlis-E-Inquilab-E-Millat,1592,0,1592,0.89,57
6,7,SYED RUKNUDDIN AHMAD,All India Majlis-E-Ittehadul Muslimeen,68162,254,68416,38.27,57
7,8,HASIB,Janta Dal Rashtravadi,1592,3,1595,0.89,57
8,9,GHULAM SARWAR,Independent,5055,20,5075,2.84,57
9,10,NAVAL KISHOR BISHWAS,Independent,1116,1,1117,0.62,57
10,11,MD RASHID RAZA,Independent,2622,4,2626,1.47,57
11,12,SARVESH KUMAR,Independent,970,1,971,0.54,57
12,13,NOTA,None of the Above,3037,5,3042,1.7,57
0,1,MD. AFAQUE ALAM,Indian National Congress,77110,300,77410,41.12,58
1,2,PRADEEP KUMAR DAS,Lok Jan Shakti Party,60029,103,60132,31.94,58
2,3,KUMAR SAHEV,Satya Bahumat Party,1534,0,1534,0.81,58
3,4,PRADHAN KUMAR SINGH,Rashtriya Janshakti Party (Secular),624,0,624,0.33,58
4,5,BAMBAM SAH,Sarv Jan Party (Bharat),717,4,721,0.38,58
5,6,MANOJ MAHTO,Anti Corruption Dynamic Party,586,0,586,0.31,58
6,7,MOHAMMAD NURUL HAQUE,SOCIAL DEMOCRATIC PARTY OF INDIA,2744,2,2746,1.46,58
7,8,RAJENDRA YADAV,Hindustani Awam Morcha (Secular),23658,58,23716,12.6,58
8,9,SHAKTI NATH YADAV,Right to Recall Party,1167,1,1168,0.62,58
9,10,MD SHAHBAZ ALAM,All India Majlis-E-Ittehadul Muslimeen,5302,14,5316,2.82,58
10,11,SANTOSH KUMAR @ MANTU,Rashtravadi Janata Party,692,0,692,0.37,58
11,12,HAYAT ASHRAF,The Plurals Party,1580,1,1581,0.84,58
12,13,MD ITTEFAQUE ALAM @ MUNNA BHAI,Independent,7999,10,8009,4.25,58
13,14,NOTA,None of the Above,4012,0,4012,2.13,58
0,1,Upendra Sharma,Rashtriya Janata Dal,65538,313,65851,36.41,59
1,2,Krishna Kumar Rishi,Bharatiya Janata Party,93410,184,93594,51.74,59
2,3,Umesh Rishi,Janta Dal Rashtravadi,2030,3,2033,1.12,59
3,4,Kumar Ji,Lok Shakti Party (Loktantrik),509,3,512,0.28,59
4,5,Krishna  Kumari,The Plurals Party,991,7,998,0.55,59
5,6,Dipnarayan Rishidev,Rashtra Sewa Dal,356,1,357,0.2,59
6,7,Nityanand Paswan,Samata Party,419,0,419,0.23,59
7,8,Ramsewak Rishideo,Apna Kisan Party,588,1,589,0.33,59
8,9,Sanjiv Kumar Paswan,Jan Adhikar Party (Loktantrik),3590,10,3600,1.99,59
9,10,Subhash Chandra Paswan,Shiv Sena,505,1,506,0.28,59
10,11,Gujay Rishidew,Independent,1056,0,1056,0.58,59
11,12,Chandan Bharti,Independent,2135,0,2135,1.18,59
12,13,Shyam Deo Paswan,Independent,3842,3,3845,2.13,59
13,14,NOTA,None of the Above,5384,0,5384,2.98,59
0,1,BIMA BHARTI,Janata Dal (United),64172,152,64324,34.52,60
1,2,BRAJNANDAN PODDAR,Bahujan Samaj Party,1407,5,1412,0.76,60
2,3,VIKASH CHANDRA MANDAL,Communist Party of India,41646,317,41963,22.52,60
3,4,SHANKAR SINGH,Lok Jan Shakti Party,44829,165,44994,24.15,60
4,5,USHA DEVI,Bhartiya Lokmat Rashtrwadi Party,1323,3,1326,0.71,60
5,6,MD. QUAMRUZ ZAMAN,Rashtriya Secular Majlis Party,1762,0,1762,0.95,60
6,7,DEEPAK KUMAR SHARMA,Jan Adhikar Party,3130,4,3134,1.68,60
7,8,RUBY KUMARI,Vanchit Samaj Party,880,1,881,0.47,60
8,9,VIRENDRA KUMAR,Janvadi Party(Socialist),940,2,942,0.51,60
9,10,SIKANDAR SINGH,Rashtriya Jansambhavna Party,1511,2,1513,0.81,60
10,11,ABHAY SINGH,Independent,1167,2,1169,0.63,60
11,12,KALADHAR PRASAD MANDAL,Independent,6183,14,6197,3.33,60
12,13,NILAM DEVI,Independent,4075,2,4077,2.19,60
13,14,PREMPARKASH MANDAL,Independent,5582,11,5593,3,60
14,15,MANOJ KUMAR BHARTI,Independent,2361,2,2363,1.27,60
15,16,NOTA,None of the Above,4683,3,4686,2.51,60
0,1,MD GAISUL AZAM,Nationalist Congress Party,1868,1,1869,0.93,61
1,2,DILIP KUMAR YADAV,Rashtriya Janata Dal,63057,406,63463,31.71,61
2,3,YOGENDRA KUMAR,Lok Jan Shakti Party,9415,33,9448,4.72,61
3,4,RAMESH KUMAR MEHTA,Rashtriya Lok Samta Party,3389,9,3398,1.7,61
4,5,LESHI SINGH,Janata Dal (United),96758,299,97057,48.5,61
5,6,KISHOR KUMAR YADAV,Lok Shakti Party (Loktantrik),1288,3,1291,0.65,61
6,7,CHAKRADHAR PASWAN,Peoples Party of India (Democratic),815,2,817,0.41,61
7,8,BIMAL ROY,Bhartiya Lokmat Rashtrwadi Party,577,5,582,0.29,61
8,9,BRAHCHARI VYAS NANDAN,Janta Dal Rashtravadi,2054,4,2058,1.03,61
9,10,RAM KUMAR,Anti Corruption Dynamic Party,560,0,560,0.28,61
10,11,SYED SHAH IQBAL ALAM,Janata Party,1398,0,1398,0.7,61
11,12,ASHISH ANUJ,Independent,4333,3,4336,2.17,61
12,13,DIPAK PODAR,Independent,1450,2,1452,0.73,61
13,14,BRAJESH KUMAR THAKUR,Independent,2512,3,2515,1.26,61
14,15,MANEESH KUMAR YADAV,Independent,2520,3,2523,1.26,61
15,16,BINDESHWARI SHARMA,Independent,2524,1,2525,1.26,61
16,17,SANJEET KUMAR,Independent,1447,0,1447,0.72,61
17,18,SUBHASH KUMAR RAJAK,Independent,2000,1,2001,1,61
18,19,NOTA,None of the Above,1389,3,1392,0.7,61
0,1,MD. ASLAM AZAD,Nationalist Congress Party,818,0,818,0.44,62
1,2,INDU SINHA,Indian National Congress,65171,432,65603,35.42,62
2,3,VIJAY KUMAR KHEMKA,Bharatiya Janata Party,97459,298,97757,52.78,62
3,4,BIDYANAND MEHTA,Rashtriya Lok Samta Party,1405,12,1417,0.77,62
4,5,ANISHA PRITY,The Plurals Party,610,3,613,0.33,62
5,6,ABDUL SUBHAN,Bhartiya Jantantrik Janata Dal,274,0,274,0.15,62
6,7,PRADIP KUMAR,Angika Samaj Party,288,1,289,0.16,62
7,8,MANOJ THAKUR,Bhartiya Lokmat Rashtrwadi Party,500,0,500,0.27,62
8,9,MIHIR ANAND,Janata Party,239,0,239,0.13,62
9,10,RAVINDRA KUMAR SINGH,Jantantrik Vikas Party,322,2,324,0.17,62
10,11,VIJAY ORAON,SOCIAL DEMOCRATIC PARTY OF INDIA,5482,11,5493,2.97,62
11,12,VINOD SINGH,Aam Janta Party Rashtriya,573,0,573,0.31,62
12,13,SHAIKH AKBAR ALI,Janata Dal  (Secular),718,2,720,0.39,62
13,14,SANJAY SINGH,Apna Kisan Party,1922,2,1924,1.04,62
14,15,AJAY SWARN,Independent,1074,4,1078,0.58,62
15,16,ASHOK KUMAR SINGH,Independent,1379,0,1379,0.74,62
16,17,CHANDRA BHANU KUMAR,Independent,526,1,527,0.28,62
17,18,NITYANAND CHOUDHARY,Independent,1291,0,1291,0.7,62
18,19,NEERAJ KUMAR SINHA,Independent,1740,2,1742,0.94,62
19,20,RAJESH KUMAR THAKUR,Independent,259,1,260,0.14,62
20,21,RAJESH KUMAR NIRALA,Independent,519,0,519,0.28,62
21,22,SHYAM MOHAN JHA ALIAS S. M.JHA,Independent,634,2,636,0.34,62
22,23,SUMIT SINGH,Independent,274,0,274,0.15,62
23,24,NOTA,None of the Above,946,5,951,0.51,62
0,1,Tarkishore Prasad,Bharatiya Janata Party,82105,564,82669,48.47,63
1,2,Rajesh Gurnani,Nationalist Congress Party,2166,7,2173,1.27,63
2,3,Dr. Ram Prakash Mahto,Rashtriya Janata Dal,70922,1228,72150,42.3,63
3,4,Ajay Kumar Sah,Suheldev Bharatiya Samaj Party,752,3,755,0.44,63
4,5,Kundan Kumar,Janata Party,512,3,515,0.3,63
5,6,Janardan Singh,Right to Recall Party,228,1,229,0.13,63
6,7,Md Zameed,SOCIAL DEMOCRATIC PARTY OF INDIA,956,8,964,0.57,63
7,8,Dilip Kumar Poddar,Janata Dal  (Secular),270,1,271,0.16,63
8,9,Poonam Devi,Bharat Jago Janta Party,275,3,278,0.16,63
9,10,Manisha Kumari,Peoples Party of India (Democratic),289,5,294,0.17,63
10,11,Afaque Ainul,Independent,349,3,352,0.21,63
11,12,Ashok Kumar Bhagat,Independent,383,1,384,0.23,63
12,13,Kamal Sharma,Independent,614,1,615,0.36,63
13,14,Chandan Kishore,Independent,1488,0,1488,0.87,63
14,15,Bibhaker Jha Alies Victor Jha,Independent,1177,15,1192,0.7,63
15,16,Mohammad Kalamuddin  Ansari Alies Kalam,Independent,2531,2,2533,1.49,63
16,17,Sanjay Singh,Independent,1492,1,1493,0.88,63
17,18,Satyanarayan Agrawal,Independent,319,1,320,0.19,63
18,19,Samir Kumar Jha,Independent,1091,1,1092,0.64,63
19,20,NOTA,None of the Above,772,15,787,0.46,63
0,1,UMA KANT ANAND,Rashtriya Lok Samta Party,1897,3,1900,1.12,64
1,2,CHANDRA BHUSHAN THAKUR,Lok Jan Shakti Party,38598,267,38865,22.9,64
2,3,NIZAM,Nationalist Congress Party,1631,7,1638,0.97,64
3,4,SHAKEEL AHMAD KHAN,Indian National Congress,70517,750,71267,42,64
4,5,SURAJ PRAKASH ROY,Janata Dal (United),31581,198,31779,18.73,64
5,6,ANMOL KUMAR,Voters Party  International,766,0,766,0.45,64
6,7,NIRANJAN KUMAR JHA,Janta Dal Rashtravadi,952,0,952,0.56,64
7,8,NUSARAT PRAVIN,Peoples Party of India (Democratic),833,15,848,0.5,64
8,9,PRAMOD DAS,Aam Janta Party Rashtriya,676,1,677,0.4,64
9,10,MANISH KUMAR MANDAL,The Plurals Party,967,3,970,0.57,64
10,11,MD RAZAUL HAQUE,Jan Adhikar Party (Loktantrik),1318,4,1322,0.78,64
11,12,BINOD KUMAR SINGH,Rashtriya Jansangharsh Swaraj Party,1113,1,1114,0.66,64
12,13,MD ANWAR ALAM,Independent,1600,1,1601,0.94,64
13,14,MANORANJAN PRASAD DAS,Independent,1716,5,1721,1.01,64
14,15,MINU KUMARI,Independent,3713,0,3713,2.19,64
15,16,RANJEET PRASAD DAS,Independent,2284,0,2284,1.35,64
16,17,SAJAN KUMAR,Independent,1681,13,1694,1,64
17,18,HIMRAJ SINGH,Independent,5099,65,5164,3.04,64
18,19,NOTA,None of the Above,1404,1,1405,0.83,64
0,1,KHAWAJA BAHAUDDIN AHMED,Nationalist Congress Party,3435,8,3443,1.68,65
1,2,SANGITA DEVI,Lok Jan Shakti Party,8853,96,8949,4.38,65
2,3,AZAD KHAN,Rashtriya Jankranti Party,4745,2,4747,2.32,65
3,4,MD. NOOR ALAM,Peace Party,826,0,826,0.4,65
4,5,MD. FAKHRUDDIN,Janata Dal  (Secular),1160,0,1160,0.57,65
5,6,BARUN KUMAR JHA,Vikassheel Insaan Party,50668,224,50892,24.89,65
6,7,MAHBOOB ALAM,Communist Party of India  (Marxist-Leninist)  (Liberation),103746,743,104489,51.11,65
7,8,MUNOVAR HUSAIN,SOCIAL DEMOCRATIC PARTY OF INDIA,3247,7,3254,1.59,65
8,9,MD. SHAMIM AKHTAR,Peoples Party of India (Democratic),3072,0,3072,1.5,65
9,10,SAKIR ALAM,Bahujan Mukti Party,2870,2,2872,1.4,65
10,11,JAGANNATH DAS,Independent,4054,36,4090,2,65
11,12,MD. ZINNAH,Independent,7841,37,7878,3.85,65
12,13,TANWEER SHAMSI,Independent,2039,2,2041,1,65
13,14,SUNIL CHAUDHARY,Independent,1559,1,1560,0.76,65
14,15,NOTA,None of the Above,5159,7,5166,2.53,65
0,1,TAUQUIR ALAM,Indian National Congress,76326,676,77002,38.48,66
1,2,NISHA SINGH,Bharatiya Janata Party,79592,382,79974,39.97,66
2,3,ABDUS SALAM,Azad Samaj Party,1257,3,1260,0.63,66
3,4,GANGA KEWAT,Rashtriya Jansambhavna Party,609,2,611,0.31,66
4,5,DILIP KUMAR CHOUDHARY,Anti Corruption Dynamic Party,360,0,360,0.18,66
5,6,MANOJ MURMU,Bahujan Mukti Party,2645,1,2646,1.32,66
6,7,HASSAN MAHMOOD AHAMAD,All India Majlis-E-Ittehadul Muslimeen,507,1,508,0.25,66
7,8,AJAY SINGH,Independent,3396,5,3401,1.7,66
8,9,ISHRAT PARWEEN,Independent,19585,161,19746,9.87,66
9,10,KISHOR MANDAL,Independent,3565,38,3603,1.8,66
10,11,JAWED RAHI,Independent,911,1,912,0.46,66
11,12,DILIP KUMAR DIWAKAR,Independent,1006,2,1008,0.5,66
12,13,SUDARSHAN CHANDRA PAUL,Independent,5857,31,5888,2.94,66
13,14,NOTA,None of the Above,3167,1,3168,1.58,66
0,1,ANIL KUMAR ORAON,Lok Jan Shakti Party,20280,161,20441,11.28,67
1,2,MANOHAR PRASAD SINGH,Indian National Congress,82253,779,83032,45.81,67
2,3,SHAMBHU KUMAR SUMAN,Janata Dal (United),61574,249,61823,34.11,67
3,4,ARUN URAWN,Peoples Party of India (Democratic),1262,11,1273,0.7,67
4,5,GORETI MURMU,All India Majlis-E-Ittehadul Muslimeen,2458,17,2475,1.37,67
5,6,NAGENDRA CHANDRA MANDAL,Shiv Sena,687,0,687,0.38,67
6,7,FULAMANI HEMBRAM,Jharkhand Mukti Morcha,1058,1,1059,0.58,67
7,8,SHIV NARAYAN,Janata Dal  (Secular),937,2,939,0.52,67
8,9,MINAKSHI SHWETA,Independent,1663,4,1667,0.92,67
9,10,RAMESHWAR HEMBRAM,Independent,2568,0,2568,1.42,67
10,11,SHOBHA SOREN,Independent,1840,0,1840,1.02,67
11,12,NOTA,None of the Above,3454,2,3456,1.91,67
0,1,Neeraj Kumar,Rashtriya Janata Dal,70473,841,71314,39,68
1,2,Bijay Singh,Janata Dal (United),81320,432,81752,44.71,68
2,3,Bibhash Chandra Choudhary,Lok Jan Shakti Party,7804,116,7920,4.33,68
3,4,Md. Shamsad Alam,Nationalist Congress Party,1077,6,1083,0.59,68
4,5,Kavindra Kumar Paul,Bhartiya Sablog Party,1352,6,1358,0.74,68
5,6,Tanuja Khatoon,The Plurals Party,1169,3,1172,0.64,68
6,7,Nasim akhtar,SOCIAL DEMOCRATIC PARTY OF INDIA,1064,12,1076,0.59,68
7,8,Md. Parvez Alam,Loktantrik Janta Dal,1560,34,1594,0.87,68
8,9,Rakesh Kumar Raushan,All India Majlis-E-Ittehadul Muslimeen,6564,34,6598,3.61,68
9,10,Lal krishna prasad,Apna Kisan Party,464,3,467,0.26,68
10,11,Shailesh kumar singh,Peoples Party of India (Democratic),561,3,564,0.31,68
11,12,MD. Saghir Alam,Jan Adhikar Party,1046,3,1049,0.57,68
12,13,Md. Babar,Independent,1309,0,1309,0.72,68
13,14,Srikant Mandal,Independent,1942,1,1943,1.06,68
14,15,NOTA,None of the Above,3651,1,3652,2,68
0,1,KAVITA DEVI,Bharatiya Janata Party,104165,460,104625,53.31,69
1,2,PUNAM KUMARI ALIAS PUNAM PASWAN,Indian National Congress,75158,524,75682,38.56,69
2,3,MANJU DEVI,Nationalist Congress Party,1383,10,1393,0.71,69
3,4,LALIT KUMAR,Rashtriya Lok Samta Party,2138,13,2151,1.1,69
4,5,KUMAR RAVI,Peoples Party of India (Democratic),324,0,324,0.17,69
5,6,JAGDISH PRASAD,Bharat Jago Janta Party,416,2,418,0.21,69
6,7,BHOLA PASWAN,Bahujan Mukti Party,451,0,451,0.23,69
7,8,WAKIL DAS,Jan Adhikar Party (Loktantrik),3565,89,3654,1.86,69
8,9,SITA RAM DASS,Janata Dal  (Secular),629,3,632,0.32,69
9,10,ARJUN RAM,Independent,744,0,744,0.38,69
10,11,KULDIP PASWAN,Independent,953,2,955,0.49,69
11,12,JAI PRAKAS DAS,Independent,1464,3,1467,0.75,69
12,13,NOTA,None of the Above,3763,1,3764,1.92,69
0,1,MD. IFTEKHAR ALAM,Rashtriya Lok Samta Party,4595,1,4596,2.16,70
1,2,NABIN KUMAR,Rashtriya Janata Dal,73240,597,73837,34.69,70
2,3,NARENDRA NARAYAN YADAV,Janata Dal (United),102335,182,102517,48.17,70
3,4,SUNILA DEVI,Lok Jan Shakti Party,9263,24,9287,4.36,70
4,5,ABHISHEK ANAND,The Plurals Party,1182,0,1182,0.56,70
5,6,NARESH MANDAL,Rashtriya Jan Jan Party,1828,0,1828,0.86,70
6,7,PRASHANT KUMAR JHA,Lok Shakti Party (Loktantrik),1213,0,1213,0.57,70
7,8,RAJNANDAN KUMAR SINHA,Samata Party,2254,0,2254,1.06,70
8,9,SARVESHWAR PRASAD SINGH,Jan Adhikar Party (Loktantrik),8457,9,8466,3.98,70
9,10,SUDHANSHU KUMAR,Bharat Jago Janta Party,3053,1,3054,1.43,70
10,11,NOTA,None of the Above,4592,3,4595,2.16,70
0,1,NIRANJAN KUMAR MEHTA,Janata Dal (United),81109,422,81531,43.63,71
1,2,VIJAY KUMAR SINGH,Lok Jan Shakti Party,8693,71,8764,4.69,71
2,3,SUBHASHINI BUNDELA ALIAS SUBHASHINI SHARAD YADAV,Indian National Congress,61650,1170,62820,33.61,71
3,4,OM KUMAR,Bhartiya Mahasangh Party,1251,4,1255,0.67,71
4,5,KAUSHAL KUMAR,Bharatiya Jan Kranti Dal (Democratic),579,2,581,0.31,71
5,6,JAYANT YADAV,The Plurals Party,586,4,590,0.32,71
6,7,DHARMENDRA KUMAR,Janvadi Party(Socialist),1395,9,1404,0.75,71
7,8,PANKAJ KUMAR JAYSWAL,SOCIALIST UNITY CENTRE OF INDIA (COMMUNIST),1579,6,1585,0.85,71
8,9,PRABHASH KUMAR,Jan Adhikar Party (Loktantrik),5555,49,5604,3,71
9,10,PRAMOD KUMAR NIRALA,Jagrook Janta Party,623,4,627,0.34,71
10,11,MD MASUM RAJA,Bhartiya Rashtriya Dal,950,0,950,0.51,71
11,12,MOHAN KUMAR,Rashtra Sewa Dal,973,3,976,0.52,71
12,13,RAJEEV RANGAN BHARTI,Apna Kisan Party,1326,2,1328,0.71,71
13,14,VIJAY PRABHAT,Proutist Sarva Samaj,2796,6,2802,1.5,71
14,15,SHANKAR KUMAR,Lok Shakti Party (Loktantrik),1633,4,1637,0.88,71
15,16,SHAKUNTALA DEVI,Sanyukt Vikas Party,4878,5,4883,2.61,71
16,17,SUMIT KUMAR ALIAS SUMITRANANDAN SWAMI,Rashtrawadi Janlok Party (Satya),3305,4,3309,1.77,71
17,18,ANIRUDDH MEHTA,Independent,707,2,709,0.38,71
18,19,ANILA DEVI,Independent,1766,3,1769,0.95,71
19,20,ARUN KUMAR HEMBRAM,Independent,1116,5,1121,0.6,71
20,21,KAMLASHWARI DAS,Independent,468,1,469,0.25,71
21,22,SADANAND PASWAN,Independent,579,0,579,0.31,71
22,23,NOTA,None of the Above,1586,4,1590,0.85,71
0,1,AMIT KUMAR BHARTI,Lok Jan Shakti Party,5586,21,5607,2.94,72
1,2,CHANDRAHAS CHAUPAL,Rashtriya Janata Dal,85395,786,86181,45.13,72
2,3,RAMESH RISHIDEV,Janata Dal (United),80400,208,80608,42.21,72
3,4,RAMDEO RAM,Bahujan Samaj Party,1656,8,1664,0.87,72
4,5,SANJAY SADA,Nationalist Congress Party,564,2,566,0.3,72
5,6,ANIL KUMAR BANDHU,Jan Adhikar Party (Loktantrik),3824,6,3830,2.01,72
6,7,GULABCHAND DAS,Aadarsh Mithila Party,1716,1,1717,0.9,72
7,8,TRIFUL DEVI,Jai Maha Bharath Party,2133,0,2133,1.12,72
8,9,SHIVJEE RAM,"Aam Janmat Party,",2354,0,2354,1.23,72
9,10,SURENDRA SHARMA,Bhartiya Lokmat Rashtrwadi Party,2292,0,2292,1.2,72
10,11,NOTA,None of the Above,3995,3,3998,2.09,72
0,1,CHANDRA SHEKHAR,Rashtriya Janata Dal,79839,0,79839,39.24,73
1,2,NIKHIL MANDAL,Janata Dal (United),64767,0,64767,31.83,73
2,3,SAAKAR SURESH YADAV,Lok Jan Shakti Party,6326,0,6326,3.11,73
3,4,JANESHWAR SHARMA,"Log Jan Party - Secular,",818,0,818,0.4,73
4,5,GYANDEV BACHAN,Lok Shakti Party (Loktantrik),705,0,705,0.35,73
5,6,RAJESH RANJAN ALIAS PAPPU YADAV,Jan Adhikar Party (Loktantrik),26462,0,26462,13.01,73
6,7,SUNIL KUMAR SUMAN,Proutist Sarva Samaj,837,0,837,0.41,73
7,8,AMARDEEP KUMAR,Independent,1285,0,1285,0.63,73
8,9,UPENDRA KAMAT,Independent,516,0,516,0.25,73
9,10,DINESH YADAV URF FAUJI,Independent,1133,0,1133,0.56,73
10,11,MANDEV TANTI,Independent,984,0,984,0.48,73
11,12,RANBEER RANJAN,Independent,946,0,946,0.46,73
12,13,RAVINDRA KUMAR SAH,Independent,1218,0,1218,0.6,73
13,14,LALAN KUMAR,Independent,2825,0,2825,1.39,73
14,15,LALO RISHIDEV,Independent,1977,0,1977,0.97,73
15,16,VIKRAM KUMAR,Independent,4293,0,4293,2.11,73
16,17,SHASHI KUMAR,Independent,5534,0,5534,2.72,73
17,18,SURESH KUMAR,Independent,1637,0,1637,0.8,73
18,19,NOTA,None of the Above,1349,0,1349,0.66,73
0,1,KIRAN DEVI,Bahujan Samaj Party,2843,5,2848,1.69,74
1,2,TARNI RISHIDEO,Indian National Congress,53798,414,54212,32.2,74
2,3,PAWAN PASWAN,Nationalist Congress Party,1792,0,1792,1.06,74
3,4,RATNESH SADA,Janata Dal (United),67530,148,67678,40.2,74
4,5,SARITA DEVI,Lok Jan Shakti Party,13487,79,13566,8.06,74
5,6,AMIR RAM,The Plurals Party,1036,1,1037,0.62,74
6,7,UMESH PASWAN,Jantantrik Lokhit Party,881,3,884,0.53,74
7,8,PRITHVI CHANDRA SADA,Rashtriya Jansambhavna Party,759,0,759,0.45,74
8,9,PRANJAL RANJAN KUMAR URF DILKHUSH PASWAN,Jantantrik Vikas Party,705,0,705,0.42,74
9,10,MANOJ PASWAN,Jan Adhikar Party (Loktantrik),4780,10,4790,2.85,74
10,11,UPENDRA RAM,Independent,1037,0,1037,0.62,74
11,12,BHUMI PASWAN,Independent,2547,0,2547,1.51,74
12,13,MANJAY KUMAR,Independent,2774,1,2775,1.65,74
13,14,RAMESH KUMAR SHARMA,Independent,3381,1,3382,2.01,74
14,15,RAJESH RAM,Independent,4891,2,4893,2.91,74
15,16,SIKANDAR SADA,Independent,3749,1,3750,2.23,74
16,17,NOTA,None of the Above,1700,1,1701,1.01,74
0,1,Alok Ranjan,Bharatiya Janata Party,103199,339,103538,45.59,75
1,2,Lovely Anand,Rashtriya Janata Dal,83022,837,83859,36.93,75
2,3,Bidhan Chandra Jha,Nationalist Congress Party,1198,1,1199,0.53,75
3,4,Amar kant Vats urf Sohan Jha,Jantantrik Vikas Party,902,5,907,0.4,75
4,5,Kamal Deo Sharma,"Log Jan Party - Secular,",734,4,738,0.32,75
5,6,Krishna Shekhar,Samajwadi Janata Dal Democratic,611,2,613,0.27,75
6,7,Ranjan Priyadarshi,Jan Adhikar Party (Loktantrik),1495,10,1505,0.66,75
7,8,Rajesh Kumar Jha,The Plurals Party,842,3,845,0.37,75
8,9,Vimlesh Kumar Singh,Nationalist Janshakti Party,530,0,530,0.23,75
9,10,Amit Kumar,Independent,651,7,658,0.29,75
10,11,Kishor Kumar,Independent,12525,67,12592,5.54,75
11,12,Ranjit Kumar Rana,Independent,9938,56,9994,4.4,75
12,13,Birendra Kumar,Independent,1544,1,1545,0.68,75
13,14,Siyaram Paswan,Independent,3272,4,3276,1.44,75
14,15,NOTA,None of the Above,5304,3,5307,2.34,75
0,1,YUSUF SALAHUDDIN,Rashtriya Janata Dal,75201,483,75684,38.48,76
1,2,VINAY KUMAR MISHRA,Nationalist Congress Party,948,1,949,0.48,76
2,3,SANJAY KUMAR SINGH,Lok Jan Shakti Party,6940,22,6962,3.54,76
3,4,SONA KUMAR,Bahujan Samaj Party,781,0,781,0.4,76
4,5,UPENDRA SAHANI,Rashtriya Jansambhavna Party,911,1,912,0.46,76
5,6,UMESH CHANDRA BHARTI,Aadarsh Mithila Party,5295,1,5296,2.69,76
6,7,ZAFAR ALAM,Jan Adhikar Party (Loktantrik),3986,26,4012,2.04,76
7,8,DHIRENDRA CHOUDHARY,Aam Adhikar Morcha,2259,1,2260,1.15,76
8,9,PARAS PASWAN,Bahujan Mukti Party,1543,2,1545,0.79,76
9,10,PINTU SHARMA,"Log Jan Party - Secular,",2134,3,2137,1.09,76
10,11,MUKESH SAHANI,Vikassheel Insaan Party,73731,194,73925,37.58,76
11,12,RAJESH KUMAR,Lokpriya Samaj Party,2158,1,2159,1.1,76
12,13,SUNDARAM,Republican Party of India (Athawale),1704,0,1704,0.87,76
13,14,HASHIM,Samta Dal (Pragatisheel),1243,1,1244,0.63,76
14,15,UPENDRA YADAV,Independent,1669,0,1669,0.85,76
15,16,KHAGESH KUMAR SAH,Independent,4748,4,4752,2.42,76
16,17,DOMI SHARMA,Independent,2635,0,2635,1.34,76
17,18,TARUN KUMAR JHA,Independent,546,0,546,0.28,76
18,19,YOGAVIR ROY,Independent,440,1,441,0.22,76
19,20,RITESH RANJAN,Independent,2830,10,2840,1.44,76
20,21,BANDAN KUMAR SINGH,Independent,479,0,479,0.24,76
21,22,SULENDRA DAS,Independent,2361,0,2361,1.2,76
22,23,NOTA,None of the Above,1406,1,1407,0.72,76
0,1,ABDUR RAZZAQUE,Lok Jan Shakti Party,22016,94,22110,12.61,77
1,2,GUNJESHWAR SAH,Janata Dal (United),66125,191,66316,37.83,77
2,3,GAUTAM KRISHNA,Rashtriya Janata Dal,64153,533,64686,36.9,77
3,4,SHIVENDRA KUMAR,Rashtriya Lok Samta Party,3718,13,3731,2.13,77
4,5,"SUNIT KUMAR SINGH ""CHAUHAN""",Nationalist Congress Party,403,0,403,0.23,77
5,6,GUDDU KUMAR,Rashtra Sewa Dal,348,0,348,0.2,77
6,7,TRIPURARI PRASAD SINGH,The Plurals Party,502,1,503,0.29,77
7,8,Nehal Akhtar,Mazdoor Ekta Party,628,1,629,0.36,77
8,9,MUNNA MANDAL,Rashtriya Samaj Paksha,413,0,413,0.24,77
9,10,MOHAMMAD ARSHAD HUSSAIN,Bahujan Maha Party,1233,0,1233,0.7,77
10,11,RAJIV KUMAR YADAV,Bhartiya Sablog Party,856,0,856,0.49,77
11,12,RAJIV DAS,Bhartiya Mahasangh Party,778,2,780,0.44,77
12,13,MAHARUDRA JHA,Independent,1210,0,1210,0.69,77
13,14,YOGENDAR MUKHIYA,Independent,4742,1,4743,2.71,77
14,15,RAMA SHANKAR SINGH,Independent,4337,1,4338,2.47,77
15,16,NOTA,None of the Above,3005,3,3008,1.72,77
0,1,Dr. ASHOK KUMAR,Indian National Congress,46576,182,46758,34.26,78
1,2,POONAM KUMARI,Lok Jan Shakti Party,13343,19,13362,9.79,78
2,3,LAXMI PASWAN,Rashtriya Lok Samta Party,2060,0,2060,1.51,78
3,4,SHASHIBHUSHAN HAJARI,Janata Dal (United),53952,28,53980,39.55,78
4,5,ABDHESH PASWAN,Satya Bahumat Party,877,0,877,0.64,78
5,6,ANAND KUMAR,Rashtriya Jan Kalyan Party Secular,738,0,738,0.54,78
6,7,CHAND DEVI,Wazib Adhikar Party,589,1,590,0.43,78
7,8,JAY JAY RAM,Aam Janta Party Rashtriya,471,0,471,0.35,78
8,9,DROPADI DEVI,Mazdoor Ekta Party,684,0,684,0.5,78
9,10,MURARI PASWAN,Jan Adhikar Party (Loktantrik),1804,1,1805,1.32,78
10,11,RENU RAJ,Rashtriya Janvikas Party (Democratic),1152,0,1152,0.84,78
11,12,LAL MOHAR SADA,"Log Jan Party - Secular,",2116,1,2117,1.55,78
12,13,KAMESHWAR RAM,Independent,3864,0,3864,2.83,78
13,14,GANESH KUMAR,Independent,1392,0,1392,1.02,78
14,15,YOGI CHAUPAL,Independent,3487,2,3489,2.56,78
15,16,NOTA,None of the Above,3142,0,3142,2.3,78
0,1,AFZAL ALI KHAN,Rashtriya Janata Dal,51970,288,52258,36.21,79
1,2,TAMANNA KHAN,Nationalist Congress Party,1018,1,1019,0.71,79
2,3,RAJEEV KUMAR THAKUR,Lok Jan Shakti Party,9111,12,9123,6.32,79
3,4,KAMLESH RAY,The Plurals Party,635,0,635,0.44,79
4,5,KUNDAN PRASAD SHAH,"Aam Janmat Party,",748,0,748,0.52,79
5,6,KHAWAJA MOHAMMAD FAKHRUDDIN,Bhartiya Rashtriya Dal,449,0,449,0.31,79
6,7,BAIJU SAHU,Wazib Adhikar Party,415,0,415,0.29,79
7,8,RANJIT SAHNI,Bahujan Mukti Party,352,1,353,0.24,79
8,9,RAMESH KUMAR PANDIT,Janata Dal  (Secular),354,0,354,0.25,79
9,10,VISHWAMBHAR YADAV,Jan Adhikar Party (Loktantrik),597,0,597,0.41,79
10,11,SHUBH KANT SADA,Rashtriya Jan Kalyan Party Secular,627,0,627,0.43,79
11,12,SATYA NARAYAN PASWAN,Mazdoor Ekta Party,623,0,623,0.43,79
12,13,SAROJ KUMAR CHAUDHARY,Mithilanchal Mukti Morcha,1685,0,1685,1.17,79
13,14,SWARNA SINGH,Vikassheel Insaan Party,59489,49,59538,41.26,79
14,15,AJAY YADAV,Independent,1175,0,1175,0.81,79
15,16,DR IZHAR AHMAD,Independent,5474,11,5485,3.8,79
16,17,MD ISARAFIL,Independent,1944,0,1944,1.35,79
17,18,GAURAV KUMAR SINGH,Independent,377,1,378,0.26,79
18,19,CHANDAN KUMAR MISHRA,Independent,1209,0,1209,0.84,79
19,20,RAJNI MAHATO,Independent,3407,0,3407,2.36,79
20,21,RANDHEER KUMAR,Independent,279,0,279,0.19,79
21,22,RAHUL KUMAR JHA,Independent,527,0,527,0.37,79
22,23,SHYAM SADA,Independent,445,0,445,0.31,79
23,24,SANJAY KUMAR YADAV,Independent,257,0,257,0.18,79
24,25,NOTA,None of the Above,770,0,770,0.53,79
0,1,Kamal Ram Vinod Jha,Lok Jan Shakti Party,17585,31,17616,10.78,80
1,2,Mithilesh Kumar Choudhary,Indian National Congress,54529,297,54826,33.55,80
2,3,Rajeev Kumar,Rashtriya Lok Samta Party,4630,11,4641,2.84,80
3,4,Binay Kumar Choudhary,Janata Dal (United),61322,94,61416,37.58,80
4,5,Nathuni Ram,Wazib Adhikar Party,1927,2,1929,1.18,80
5,6,Rajesh Kumar Mishra,Jan Adhikar Party (Loktantrik),1576,0,1576,0.96,80
6,7,Sanjeev Jha,Shiv Sena,757,0,757,0.46,80
7,8,Md. Quamrul Hoda,Independent,538,0,538,0.33,80
8,9,Manoj Kumar,Independent,888,1,889,0.54,80
9,10,Mithlesh Yadav,Independent,607,1,608,0.37,80
10,11,Ranjeet Kumar Jha,Independent,966,1,967,0.59,80
11,12,Ram Kumar Jha,Independent,6215,6,6221,3.81,80
12,13,Sanjeet Kumar,Independent,3741,0,3741,2.29,80
13,14,Saguni Ray,Independent,3082,0,3082,1.89,80
14,15,NOTA,None of the Above,4620,1,4621,2.83,80
0,1,Raj Kumar Jha,Lok Jan Shakti Party,8840,10,8850,5.6,81
1,2,Binod Mishra,Rashtriya Janata Dal,57654,327,57981,36.66,81
2,3,Md Nasar Nabab,Samajwadi Janata Dal Democratic,1573,3,1576,1,81
3,4,Farhan Alam,Loktantrik Janshakti Party,1274,1,1275,0.81,81
4,5,Mishri Lal Yadav,Vikassheel Insaan Party,61024,58,61082,38.62,81
5,6,Mohammad Jamir,Wazib Adhikar Party,1704,1,1705,1.08,81
6,7,Vinod Yadav,Rashtravadi Janata Party,916,12,928,0.59,81
7,8,Sanjay Kumar Singh,Jan Adhikar Party (Loktantrik),9718,19,9737,6.16,81
8,9,Md Naseem Azam Siddiqui,Independent,2413,0,2413,1.53,81
9,10,Fakira Paswan,Independent,4468,0,4468,2.83,81
10,11,Rajipal Jha,Independent,1087,0,1087,0.69,81
11,12,Shambhu Mishra,Independent,2176,2,2178,1.38,81
12,13,Sulekha Devi,Independent,1936,2,1938,1.23,81
13,14,NOTA,None of the Above,2940,1,2941,1.86,81
0,1,PRADEEP KUMAR THAKUR,Lok Jan Shakti Party,17586,19,17605,11.19,82
1,2,FARAZ FATMI,Janata Dal (United),62675,113,62788,39.9,82
2,3,Lalit Kumar Yadav,Rashtriya Janata Dal,64694,235,64929,41.26,82
3,4,SUNIL KUMAR MANDAL,Bahujan Samaj Party,1659,0,1659,1.05,82
4,5,RAKESH KUMAR MANDAL,Rashtriya Jansambhavna Party,1309,1,1310,0.83,82
5,6,AZIZUR RAHAMAN,Independent,2088,0,2088,1.33,82
6,7,DEO NARAYAN GUPTA,Independent,3032,0,3032,1.93,82
7,8,NOTA,None of the Above,3937,0,3937,2.5,82
0,1,Amar Nath Gami,Rashtriya Janata Dal,73135,370,73505,43.08,83
1,2,Sanjay Saraogi,Bharatiya Janata Party,84005,139,84144,49.32,83
2,3,MD. Amjad Khan,Samajwadi Janata Dal Democratic,709,1,710,0.42,83
3,4,Nooruddin Zangi,SOCIAL DEMOCRATIC PARTY OF INDIA,519,4,523,0.31,83
4,5,Md. Pintu Khan,Loktantrik Janshakti Party,134,1,135,0.08,83
5,6,Mahendra Kumar Paswan,"Bhartiya Garibmazdoor Party,",96,0,96,0.06,83
6,7,Mohammad Mojahid,SOCIALIST UNITY CENTRE OF INDIA (COMMUNIST),157,0,157,0.09,83
7,8,RAJ KUMAR MAHTO,Yuva Krantikari Party,118,1,119,0.07,83
8,9,RAUSHENDRA KUMAR,Bhartiya Lok Chetna Party,159,0,159,0.09,83
9,10,Lal Babu Mahto,All India Forward Bloc,117,0,117,0.07,83
10,11,Vijayshree Prasad,Republican Party of India (Athawale),212,0,212,0.12,83
11,12,Sanjay Kumar Roy,Rashtriya Unnati Party,256,1,257,0.15,83
12,13,Santosh Kumar Purve,Rashtriya Jan Vikas Party,238,0,238,0.14,83
13,14,Siya Ram Paswan,Jan Adhikar Party (Loktantrik),1040,5,1045,0.61,83
14,15,Sujeet Kumar Chaudhary,Janata Party,2093,0,2093,1.23,83
15,16,Mahendra Lal Das,Independent,2152,0,2152,1.26,83
16,17,Mithilesh Chandra Sahni,Independent,1348,0,1348,0.79,83
17,18,Shankar Kumar Jha,Independent,2755,2,2757,1.62,83
18,19,Sanjay Kumar Jha,Independent,170,0,170,0.1,83
19,20,NOTA,None of the Above,667,2,669,0.39,83
0,1,Bhola Yadav,Rashtriya Janata Dal,56508,270,56778,39.69,84
1,2,Ram Chandra Prasad,Bharatiya Janata Party,66928,102,67030,46.86,84
2,3,Rushan Nayak,Bahujan Samaj Party,1093,0,1093,0.76,84
3,4,Abdus Salam Khan,Jan Adhikar Party (Loktantrik),4888,10,4898,3.42,84
4,5,Om Prakash Mandal,Rashtriya Jan Vikas Party,708,0,708,0.49,84
5,6,Ganesh Kumar Choudhary,Yuva Krantikari Party,341,0,341,0.24,84
6,7,Geeta Devi,Independent,1725,4,1729,1.21,84
7,8,Janki Nandan Chaudhary,Independent,1122,2,1124,0.79,84
8,9,Paramajit Kumar,Independent,1241,0,1241,0.87,84
9,10,Ravindra Nath Singh,Independent,4573,2,4575,3.2,84
10,11,NOTA,None of the Above,3534,0,3534,2.47,84
0,1,Devendra Kumar Jha,Lok Jan Shakti Party,16839,34,16873,9.48,85
1,2,Madan Sahni,Janata Dal (United),68432,106,68538,38.5,85
2,3,Mohammad Salauddin,Bahujan Samaj Party,1567,10,1577,0.89,85
3,4,Ramesh Choudhary,Rashtriya Janata Dal,65617,292,65909,37.03,85
4,5,Arun Thakur,"Log Jan Party - Secular,",1301,1,1302,0.73,85
5,6,Krishna Kumar Das,Rashtriya Jan Vikas Party,1106,0,1106,0.62,85
6,7,Priyanka Singh,The Plurals Party,810,1,811,0.46,85
7,8,Birendra Kumar Paswan,Vanchit Bahujan Aaghadi,1040,1,1041,0.58,85
8,9,Manish Kumar,"Bhartiya Garibmazdoor Party,",511,1,512,0.29,85
9,10,Ram Prabhanjan Choudhary,Rashtriya Jan Jan Party,1696,3,1699,0.95,85
10,11,Rohit Kumar Paswan,Aazad Samaj Party (Kanshi Ram),1529,2,1531,0.86,85
11,12,Vikram Singh,Bhartiya Sablog Party,2443,0,2443,1.37,85
12,13,Baldeo Ram,Independent,3570,0,3570,2.01,85
13,14,Mahendra Sahani,Independent,2288,0,2288,1.29,85
14,15,Binay Kumar Singh,Independent,4938,0,4938,2.77,85
15,16,NOTA,None of the Above,3866,7,3873,2.18,85
0,1,ABDUL BARI SIDDIQUI,Rashtriya Janata Dal,71053,193,71246,43.61,86
1,2,CHAND BABU REHMAN,Nationalist Congress Party,1161,0,1161,0.71,86
2,3,MURARI MOHAN JHA,Bharatiya Janata Party,76320,52,76372,46.75,86
3,4,FAIYAZUR RAHMAN,Samajwadi Janata Dal Democratic,1528,0,1528,0.94,86
4,5,MADHU RANJAN PRASAD,Rashtriya Janshakti Party (Secular),894,2,896,0.55,86
5,6,MAHESH PURWE,Bharat Jan Jagran Dal,150,0,150,0.09,86
6,7,MADHAV KUMAR CHAUDHARY,The Plurals Party,257,0,257,0.16,86
7,8,SHEKHAR KUMAR,Rashtriya Jan Vikas Party,190,0,190,0.12,86
8,9,MD. SAMIULLAH KHAN,Jan Adhikar Party (Loktantrik),817,0,817,0.5,86
9,10,DEEPAK KUMAR JHA,Independent,798,2,800,0.49,86
10,11,PRIYANKA KUMARI,Independent,366,0,366,0.22,86
11,12,BHOLA SAHU,Independent,798,0,798,0.49,86
12,13,MANIKANT MANI,Independent,1215,2,1217,0.74,86
13,14,YOGESH RANJAN,Independent,3303,1,3304,2.02,86
14,15,SANJEEV KUMAR HIMANSHU,Independent,1290,1,1291,0.79,86
15,16,NOTA,None of the Above,2967,1,2968,1.82,86
0,1,Jibesh Kumar,Bharatiya Janata Party,87321,55,87376,51.66,87
1,2,Najir Ahmad Ansari,Nationalist Congress Party,1800,1,1801,1.06,87
2,3,Maskoor Ahmad Usmani,Indian National Congress,65395,185,65580,38.78,87
3,4,Aman Kumar Jha,Jan Adhikar Party (Loktantrik),1949,0,1949,1.15,87
4,5,Priya Ranjan Thakur,Samata Party,460,0,460,0.27,87
5,6,Mohammad Mahbub Alam,SOCIAL DEMOCRATIC PARTY OF INDIA,638,2,640,0.38,87
6,7,Satish Kumar,Rashtriya Jan Vikas Party,306,0,306,0.18,87
7,8,Bimlesh Kumar Thakur,Independent,975,0,975,0.58,87
8,9,Mahesh Kumar Jha,Independent,1817,2,1819,1.08,87
9,10,Mohammad Arshad Siddiqui,Independent,697,1,698,0.41,87
10,11,Rangnath Thakur,Independent,3085,1,3086,1.82,87
11,12,Saiyad Md. Mahtab Alam,Independent,857,1,858,0.51,87
12,13,NOTA,None of the Above,3573,0,3573,2.11,87
0,1,KOMAL SINGH,Lok Jan Shakti Party,36749,102,36851,20.29,88
1,2,NIRANJAN ROY,Rashtriya Janata Dal,59473,305,59778,32.92,88
2,3,MAHESHWAR PD YADAV,Janata Dal (United),52128,84,52212,28.75,88
3,4,AYUSH SAHNI URF MUKESH SAHNI,Lok  Chetna  Dal,843,0,843,0.46,88
4,5,ALOK KUMAR,Janhit Kisan Party,346,0,346,0.19,88
5,6,CHULIYA DEVI,Aapki Apni Adhikar Party,305,0,305,0.17,88
6,7,PRAVHU SHANI,Bajjikanchal Vikas Party,267,0,267,0.15,88
7,8,BHARAT PASWAN,Bahujan Mukti Party,398,0,398,0.22,88
8,9,RANJAN KUMAR,Samata Party,521,0,521,0.29,88
9,10,RAJPAL DAS,Rashtriya Jan Vikas Party,979,0,979,0.54,88
10,11,RIZWANUL HAQUE,Bhartiya Lokmat Rashtrwadi Party,380,0,380,0.21,88
11,12,LALITA SINGH,Jan Adhikar Party (Loktantrik),861,0,861,0.47,88
12,13,VIKASH KUMAR,Rashtriya Jan Jan Party,1536,0,1536,0.85,88
13,14,VIPALAV KUMAR PASWAN,"Aam Janmat Party,",2466,0,2466,1.36,88
14,15,SHUBHANKAR KUMAR SINGH,All India Forward Bloc,2015,0,2015,1.11,88
15,16,SUDHIR KUMAR JHA,Janata Party,3019,0,3019,1.66,88
16,17,SUBODH KUMAR SINGH,The Plurals Party,2259,1,2260,1.24,88
17,18,KUMAR ALOK,Independent,1354,1,1355,0.75,88
18,19,GANESH JHA,Independent,3142,0,3142,1.73,88
19,20,GHULAM AHMAD RAZA,Independent,554,0,554,0.31,88
20,21,THAKUR DHANANJAY SINGH,Independent,236,0,236,0.13,88
21,22,DEEPAK RAY URF BIPAT RAY,Independent,185,0,185,0.1,88
22,23,MD NAIJUL ANSARI,Independent,295,0,295,0.16,88
23,24,PRINCE KUMAR,Independent,305,0,305,0.17,88
24,25,VIJAY RANJAN,Independent,474,2,476,0.26,88
25,26,VINAY KUMAR,Independent,680,0,680,0.37,88
26,27,BINOD MAHASETH,Independent,272,0,272,0.15,88
27,28,VINDESHWAR MAHTO,Independent,1030,0,1030,0.57,88
28,29,SHIV SHANKAR KUMAR BHARTI,Independent,1098,0,1098,0.6,88
29,30,SUBHASH CHAUDHARY,Independent,2605,1,2606,1.43,88
30,31,SURESH SAHANI,Independent,2065,0,2065,1.14,88
31,32,NOTA,None of the Above,2275,2,2277,1.25,88
0,1,DINESH DAS,Bahujan Samaj Party,2191,0,2191,1.27,89
1,2,RAM SURAT KUMAR,Bharatiya Janata Party,90367,112,90479,52.33,89
2,3,ANISH KUMAR,Janata Dal  (Secular),1909,0,1909,1.1,89
3,4,AMIT KUMAR,Hindu Samaj Party,666,2,668,0.39,89
4,5,ASHOK KUMAR JHA,Garib Janshakti Party,2284,2,2286,1.32,89
5,6,MD. AFTAB ALAM,Communist Party of India  (Marxist-Leninist)  (Liberation),42359,254,42613,24.65,89
6,7,DINBANDHU KUMAR,Rashtriya Jan Jan Party,2709,9,2718,1.57,89
7,8,PRADEEP KUMAR SINGH,Shiv Sena,680,1,681,0.39,89
8,9,RAM NARAYAN ROY,Bajjikanchal Vikas Party,794,4,798,0.46,89
9,10,RITESH KUMAR ALIAS BINOD YADAV,The Plurals Party,1378,2,1380,0.8,89
10,11,BIMAL DEVI,Bhartiya Chetna Party,3555,2,3557,2.06,89
11,12,AKHILESH KUMAR,Independent,10116,16,10132,5.86,89
12,13,NAGESHWAR PRASAD SINGH,Independent,1031,1,1032,0.6,89
13,14,MOHAN KUMAR,Independent,1856,3,1859,1.08,89
14,15,SURENDRA KUMAR,Independent,8333,18,8351,4.83,89
15,16,NOTA,None of the Above,2236,1,2237,1.29,89
0,1,AJAY KUMAR,Lok Jan Shakti Party,43337,159,43496,24.28,90
1,2,PRABHU KUSHWAHA,Rashtriya Lok Samta Party,2054,5,2059,1.15,90
2,3,MANOJ KUMAR,Janata Dal (United),44412,94,44506,24.85,90
3,4,RAJEEV KUMAR,Rashtriya Janata Dal,59733,285,60018,33.51,90
4,5,AKHILESHWAR SINGH,Jai Maha Bharath Party,1987,1,1988,1.11,90
5,6,UMESH THAKUR,Yuva Krantikari Party,1018,1,1019,0.57,90
6,7,TAMANNA HASHMI,Azad Samaj Party,614,0,614,0.34,90
7,8,POONAM,Samata Party,393,2,395,0.22,90
8,9,BHARTI DEVI,Bhartiya Sanyukt Kisan Party,432,0,432,0.24,90
9,10,VEENA YADAV,Jan Adhikar Party (Loktantrik),3707,11,3718,2.08,90
10,11,BIRENDRA KUMAR,Rashtriya Jansambhavna Party,714,0,714,0.4,90
11,12,BIRENDRA KUMAR YADAV,Lok  Chetna  Dal,954,0,954,0.53,90
12,13,SANTOSH SHAHI,Bhartiya Panchyat Party,3047,0,3047,1.7,90
13,14,KANCHAN SAHNI,Independent,2517,4,2521,1.41,90
14,15,MUKESH KUMAR RANJAN,Independent,2216,3,2219,1.24,90
15,16,RAMESH KUMAR,Independent,4084,2,4086,2.28,90
16,17,LALITA KUMARI,Independent,2201,3,2204,1.23,90
17,18,BINAY KUMAR SINGH,Independent,854,1,855,0.48,90
18,19,SANTOSH KUMAR,Independent,1736,0,1736,0.97,90
19,20,SANTOSH KUMAR,Independent,1329,1,1330,0.74,90
20,21,NOTA,None of the Above,1209,4,1213,0.68,90
0,1,AMAR AZAD,Lok Jan Shakti Party,8204,28,8232,4.51,91
1,2,PRITI BHARTI,Nationalist Congress Party,1078,6,1084,0.59,91
2,3,RAMAI RAM,Rashtriya Janata Dal,65942,627,66569,36.45,91
3,4,LAL BABU PASWAN,Bahujan Samaj Party,1803,6,1809,0.99,91
4,5,ABHIMANYU KUMAR,The Plurals Party,1597,7,1604,0.88,91
5,6,CHANDAN KUMAR PASWAN,Jan Adhikar Party (Loktantrik),1455,5,1460,0.8,91
6,7,MUSAFIR PASWAN,Vikassheel Insaan Party,77557,280,77837,42.62,91
7,8,RAJGEER PASWAN,Bajjikanchal Vikas Party,2142,1,2143,1.17,91
8,9,RAJESH KUMAR,Bahujan Mukti Party,3766,6,3772,2.07,91
9,10,SANJU DEVI,Rashtriya Jan Jan Party,2637,4,2641,1.45,91
10,11,Uday Chaudhary,Independent,2940,8,2948,1.61,91
11,12,JAI CHANDRA RAM,Independent,2351,2,2353,1.29,91
12,13,DEEP LAL RAM,Independent,3258,2,3260,1.79,91
13,14,Rudal Ram,Independent,3386,12,3398,1.86,91
14,15,NOTA,None of the Above,3508,15,3523,1.93,91
0,1,Dr. Abhay Kumar,Nationalist Congress Party,1828,7,1835,1.1,92
1,2,Ashok Kumar Chodhary,Janata Dal (United),67072,193,67265,40.25,92
2,3,Umesh Kumar Ram,Indian National Congress,65330,398,65728,39.33,92
3,4,Geeta Kumari,Bahujan Samaj Party,1917,3,1920,1.15,92
4,5,Sanjay Paswan,Lok Jan Shakti Party,13487,41,13528,8.09,92
5,6,Randhir Kumar Ram,Bajjikanchal Vikas Party,1066,1,1067,0.64,92
6,7,Raj kumar Choudhary,Bhartiya Party (Loktantrik),2274,3,2277,1.36,92
7,8,Shashi Prabha Kumari,Janshakti Vikas Party (Democratic),1194,2,1196,0.72,92
8,9,Suresh Kumar,Jan Adhikar Party (Loktantrik),1932,4,1936,1.16,92
9,10,Shiv Lal Paswan,Independent,2689,1,2690,1.61,92
10,11,Suresh Mhato,Independent,3287,1,3288,1.97,92
11,12,NOTA,None of the Above,4389,3,4392,2.63,92
0,1,Anil Kumar Sahni,Rashtriya Janata Dal,78065,484,78549,40.23,93
1,2,Kedar Prasad Gupta,Bharatiya Janata Party,77585,252,77837,39.86,93
2,3,Ram Babu Singh,Rashtriya Lok Samta Party,10007,34,10041,5.14,93
3,4,Alok Kumar Sinh,Janta Dal Rashtravadi,783,1,784,0.4,93
4,5,Kali Kant Jha,SOCIALIST UNITY CENTRE OF INDIA (COMMUNIST),766,1,767,0.39,93
5,6,Jitesh Kumar,Rashtriya Jan Jan Party,508,5,513,0.26,93
6,7,Balram Kumar,Jawan Kisan Morcha,266,3,269,0.14,93
7,8,Manish Kumar,Apna Kisan Party,336,0,336,0.17,93
8,9,Mukesh Kumar Sharma,Jan Adhikar Party (Loktantrik),2777,8,2785,1.43,93
9,10,Rupchandra Kumar,Bhartiya Party (Loktantrik),335,1,336,0.17,93
10,11,Renu Devi,Prabal Bharat Party,498,3,501,0.26,93
11,12,Laxmi Devi,Rashtriya Jansambhavna Party,685,4,689,0.35,93
12,13,Virendra Kumar,Loktantrik Janta Dal,638,0,638,0.33,93
13,14,Salvi Saloni,The Plurals Party,1697,2,1699,0.87,93
14,15,Sukhdeo Prasad,Voters Party  International,3635,1,3636,1.86,93
15,16,Harindra Choudhary,Bajjikanchal Vikas Party,4354,1,4355,2.23,93
16,17,Ashok Kumar Gupta,Independent,2425,0,2425,1.24,93
17,18,Deepak Kumar Chanchal,Independent,3148,6,3154,1.62,93
18,19,Sanjay Kumar,Independent,4796,6,4802,2.46,93
19,20,NOTA,None of the Above,1137,4,1141,0.58,93
0,1,BIJENDRA CHAUDHARY,Indian National Congress,81307,564,81871,48.16,94
1,2,VIBHUTI PRIYAM,Nationalist Congress Party,503,3,506,0.3,94
2,3,SURESH KUMAR SHARMA,Bharatiya Janata Party,75175,370,75545,44.44,94
3,4,AJAY KUMAR (S/O RAGHUNATH OJHA),Bajjikanchal Vikas Party,513,0,513,0.3,94
4,5,MD. AMIN,Bhartiya Party (Loktantrik),138,0,138,0.08,94
5,6,ARVIND KUMAR CHAUDHARY,SOCIALIST UNITY CENTRE OF INDIA (COMMUNIST),105,2,107,0.06,94
6,7,AVINASH KUMAR,Loktantrik Janta Dal,123,0,123,0.07,94
7,8,KUNDAN KUMAR,Bhartiya Sanyukt Kisan Party,102,0,102,0.06,94
8,9,KUMAR HARSH,Janmat Party,173,0,173,0.1,94
9,10,KUMARI JAYA PRABHA,Bharatiya Jan Kranti Dal (Democratic),135,1,136,0.08,94
10,11,KUMARESHWAR SAHAY,Vanchit Bahujan Aaghadi,196,0,196,0.12,94
11,12,DHANAVATI DEVI,Lok  Chetna  Dal,201,1,202,0.12,94
12,13,DHARVINDRA KUMAR,Republican Party of India (A),229,0,229,0.13,94
13,14,PALLAVI SINHA,The Plurals Party,3504,18,3522,2.07,94
14,15,MANOJ KUMAR,Janta Dal Rashtravadi,345,1,346,0.2,94
15,16,RAVI ATAL,Jan Adhikar Party (Loktantrik),1552,0,1552,0.91,94
16,17,RAM BABU SAH,Jantantrik Vikas Party,1551,1,1552,0.91,94
17,18,RAMDHANI MAHATO,Bahujan Mukti Party,198,9,207,0.12,94
18,19,SHIVA BIHARI SINGHANIA,Bharat Nirman Party,569,1,570,0.34,94
19,20,SANJAY KUMAR,Samajwadi Janata Dal Democratic,136,0,136,0.08,94
20,21,AJAY KUMAR (S/O NARAYAN SINGH),Independent,60,1,61,0.04,94
21,22,AMROOP KUMAR,Independent,68,0,68,0.04,94
22,23,DEVA NAND SINGH,Independent,73,1,74,0.04,94
23,24,NAQUI AHMAD,Independent,135,0,135,0.08,94
24,25,PAPPU KUMAR,Independent,138,0,138,0.08,94
25,26,PRAVEEN JEET PUSHKAR,Independent,137,1,138,0.08,94
26,27,RAJESHWAR PRASAD,Independent,180,0,180,0.11,94
27,28,SURESH KUMAR GUPTA,Independent,243,3,246,0.14,94
28,29,NOTA,None of the Above,1243,2,1245,0.73,94
0,1,MOHAMMAD ISRAIL MANSURI,Rashtriya Janata Dal,64220,238,64458,32.89,95
1,2,MOHAMMAD JAMAL,Janata Dal (United),25837,54,25891,13.21,95
2,3,RAJENDRA KUMAR,Bahujan Samaj Party,1296,6,1302,0.66,95
3,4,BIJAY PRASAD SINGH,Lok Jan Shakti Party,18056,37,18093,9.23,95
4,5,ANSHU KUMAR,Rashtra Sewa Dal,978,2,980,0.5,95
5,6,AJIT KUMAR,Gareeb Jankranti Party,965,1,966,0.49,95
6,7,ANAY KUMAR,Rashtriya Jan Jan Party,1970,5,1975,1.01,95
7,8,ARUN PRASAD,Rashtriya Jansambhavna Party,447,3,450,0.23,95
8,9,ANAND KUMAR JHA,Lok  Chetna  Dal,1022,1,1023,0.52,95
9,10,ASHMIN KHATOON,Bhartiya Lokmat Rashtrwadi Party,482,0,482,0.25,95
10,11,GAGANDEV KUMAR CHAUHAN,Bihar Lok Nirman Dal,1389,1,1390,0.71,95
11,12,MAHAMAD JAFARUDDIN,Hindustan Sampoorna Azad Party,541,1,542,0.28,95
12,13,MALA SINHA,The Plurals Party,1273,0,1273,0.65,95
13,14,LAL BABU ROY,SOCIALIST UNITY CENTRE OF INDIA (COMMUNIST),2055,2,2057,1.05,95
14,15,SUDISTHNATH THAKUR,Bajjikanchal Vikas Party,1509,0,1509,0.77,95
15,16,SUNIL KUMAR,Janshakti Vikas Party (Democratic),2744,0,2744,1.4,95
16,17,AJIT KUMAR,Independent,53966,178,54144,27.63,95
17,18,KRISHNA DEVI,Jai Maha Bharath Party,2185,3,2188,1.12,95
18,19,GAUTAM KUMAR,Independent,553,1,554,0.28,95
19,20,NEERA DEVI,Independent,9868,17,9885,5.04,95
20,21,BINAY KUMAR BIPIN,Independent,921,2,923,0.47,95
21,22,Vimal Kumar,Independent,1623,3,1626,0.83,95
22,23,NOTA,None of the Above,1504,3,1507,0.77,95
0,1,Arun Kumar Singh,Bharatiya Janata Party,87058,349,87407,49.47,96
1,2,Nand Kumar Rai,Rashtriya Janata Dal,43510,243,43753,24.76,96
2,3,Hiralal Khadia,Bahujan Samaj Party,22564,86,22650,12.82,96
3,4,Abhay Kumar,Bajjikanchal Vikas Party,583,0,583,0.33,96
4,5,Dilip Kumar,The Plurals Party,344,0,344,0.19,96
5,6,Ranjan Kumar,Vanchit Bahujan Aaghadi,667,1,668,0.38,96
6,7,Vikki Ram,All India Majlis-E-Inquilab-E-Millat,355,0,355,0.2,96
7,8,Vidhalal Sahni,Lok  Chetna  Dal,331,2,333,0.19,96
8,9,Santosh Kumar,Hindustan Sampoorna Azad Party,377,1,378,0.21,96
9,10,Bhuneshwar Rai,Independent,1570,5,1575,0.89,96
10,11,Mazharul Haque,Independent,1570,5,1575,0.89,96
11,12,Mohammad Anzar,Independent,713,1,714,0.4,96
12,13,Rakesh Kumar,Independent,7289,15,7304,4.13,96
13,14,Sanjay Kumar Paswan,Independent,3872,5,3877,2.19,96
14,15,NOTA,None of the Above,5157,3,5160,2.92,96
0,1,ANUNAY SINHA,Indian National Congress,13736,125,13861,7.33,97
1,2,ASHOK KUMAR SINGH,Bharatiya Janata Party,77092,300,77392,40.92,97
2,3,MADAN CHAUDHARY,Rashtriya Lok Samta Party,7258,23,7281,3.85,97
3,4,AJAY PASWAN,Peoples Party of India (Democratic),814,2,816,0.43,97
4,5,DEEPAK TIWARI,Rashtriya Jansambhavna Party,6009,1,6010,3.18,97
5,6,NANHAK SAH,SOCIALIST UNITY CENTRE OF INDIA (COMMUNIST),936,9,945,0.5,97
6,7,PRAKASH KUMAR,Rashtriya Jan Jan Party,1735,14,1749,0.92,97
7,8,MONALISA,The Plurals Party,433,1,434,0.23,97
8,9,RAKESH KUMAR,Hindustan Sampoorna Azad Party,291,1,292,0.15,97
9,10,RANU NILAM SHANKAR,Jan Adhikar Party (Loktantrik),757,3,760,0.4,97
10,11,VIJAY KUMAR,Bhartiya Sablog Party,704,3,707,0.37,97
11,12,VINOD KUMAR,Sarva Samaj Janata Party,1346,3,1349,0.71,97
12,13,SANJEET KUMAR,Rashtriya Jan Vikas Party,803,0,803,0.42,97
13,14,SAKINDAR RAM,Ambedkarite Party of India,2900,1,2901,1.53,97
14,15,MITHU KUMAR,Independent,3556,2,3558,1.88,97
15,16,RAJESH RAI,Independent,2191,0,2191,1.16,97
16,17,RAMESHWAR SAH TELI,Independent,1497,2,1499,0.79,97
17,18,VIJAY THAKUR,Independent,2223,1,2224,1.18,97
18,19,SHANKAR PRASAD,Independent,62370,324,62694,33.15,97
19,20,NOTA,None of the Above,1649,5,1654,0.87,97
0,1,KRISHNA KUMAR SINGH,Lok Jan Shakti Party,5366,16,5382,2.93,98
1,2,RAMVICHAR RAI,Rashtriya Janata Dal,65643,227,65870,35.9,98
2,3,UMESH KUMAR,Rashtriya Jan Vikas Party,2654,5,2659,1.45,98
3,4,DEVESH CHANDRA,Samajwadi Janata Dal Democratic,964,3,967,0.53,98
4,5,PANKAJ KUMAR,All India Forward Bloc,824,1,825,0.45,98
5,6,PRAMOD KUMAR,Rashtriya Jan Jan Party,2849,2,2851,1.55,98
6,7,DR. MEERA KAUMUDI,The Plurals Party,1596,3,1599,0.87,98
7,8,MD. MOQEEM,All India Majlis-E-Ittehadul Muslimeen,4048,7,4055,2.21,98
8,9,DR. MOHAMMAD NABI HASSAN,All India Minorities Front,925,3,928,0.51,98
9,10,YADAV LAL PATEL,SOCIALIST UNITY CENTRE OF INDIA (COMMUNIST),1715,1,1716,0.94,98
10,11,RAJU KUMAR SINGH,Vikassheel Insaan Party,81036,167,81203,44.25,98
11,12,RAJESH KUMAR,Hindu Samaj Party,2031,0,2031,1.11,98
12,13,VEENA KUMARI,Akhand Bharat Janpriya Party,816,2,818,0.45,98
13,14,MD. SAKIM,Maanavvaadi Janta Party,1426,1,1427,0.78,98
14,15,SUDHIR KUMAR,Rashtra Sewa Dal,3886,0,3886,2.12,98
15,16,BHARAT PRASAD,Independent,2418,1,2419,1.32,98
16,17,RAJU KUMAR,Independent,679,0,679,0.37,98
17,18,SHIV KUMAR RAI,Independent,1789,0,1789,0.97,98
18,19,SUNIL KUMAR SINGH,Independent,535,0,535,0.29,98
19,20,SURESH SAHANI,Independent,754,3,757,0.41,98
20,21,NOTA,None of the Above,1104,1,1105,0.6,98
0,1,Prem Shankar Prasad,Rashtriya Janata Dal,67322,485,67807,37.01,99
1,2,Bandana Singh,Nationalist Congress Party,1168,3,1171,0.64,99
2,3,Mithilesh Tiwari,Bharatiya Janata Party,56517,177,56694,30.95,99
3,4,Atul Kr. Gautam,The Plurals Party,1071,2,1073,0.59,99
4,5,Uttam Kumar Chauhan,Janvadi Party(Socialist),941,2,943,0.51,99
5,6,Bhairaw Singh,Jan Sangharsh Virat Party,767,1,768,0.42,99
6,7,Manjit Kr Singh,Independent,43081,273,43354,23.67,99
7,8,Madan Ray,Independent,1637,0,1637,0.89,99
8,9,Manoj Kumar Ranjan,Independent,942,0,942,0.51,99
9,10,Mohan Mahto,Independent,789,0,789,0.43,99
10,11,Ranjeet Singh,Independent,833,0,833,0.45,99
11,12,Rajendra Prasad,Independent,2010,0,2010,1.1,99
12,13,Suresh Kumar Singh,Independent,1077,1,1078,0.59,99
13,14,NOTA,None of the Above,4097,0,4097,2.24,99
0,1,RAMPRAVESH RAI,Bharatiya Janata Party,81426,530,81956,46.55,100
1,2,REYAZUL HAQUE Urf RAJU,Rashtriya Janata Dal,66933,868,67801,38.51,100
2,3,SHAH ALAM,Bahujan Samaj Party,4809,47,4856,2.76,100
3,4,SACHIN KUMAR SINGH,Nationalist Congress Party,746,7,753,0.43,100
4,5,POONAM PRASAD,Janata Party,603,7,610,0.35,100
5,6,PRAMENDRA KUMAR YADAV,Subhashwadi Bhartiya Samajwadi Party (Subhas Party),155,0,155,0.09,100
6,7,MANJU KUMARI,Bharatiya Bahujan Congress,361,2,363,0.21,100
7,8,SATYENDRA KUMAR PATEL,Jantantrik Lokhit Party,319,2,321,0.18,100
8,9,Md. SAMSAD,Rashtriya Jan Jan Party,243,1,244,0.14,100
9,10,ABHISHEK RANJAN,Independent,1294,38,1332,0.76,100
10,11,AJAM TARA,Independent,507,5,512,0.29,100
11,12,CHIT LAL SAH,Independent,1757,33,1790,1.02,100
12,13,FIROJ ALI,Independent,486,3,489,0.28,100
13,14,RAMESH KUMAR GUPTA,Independent,1259,9,1268,0.72,100
14,15,RAMESH KUMAR PRASAD,Independent,4907,20,4927,2.8,100
15,16,RUDAL MAHATO,Independent,5036,1,5037,2.86,100
16,17,WASIM AKRAM,Independent,1920,0,1920,1.09,100
17,18,SUNIL KUMAR YADAW,Independent,1056,0,1056,0.6,100
18,19,NOTA,None of the Above,667,9,676,0.38,100
0,1,Anirudh Prasad Alias Sadhu Yadav,Bahujan Samaj Party,40696,343,41039,22.94,101
1,2,Asif Ghafoor,Indian National Congress,36201,259,36460,20.38,101
2,3,Sikandar Ajam,Nationalist Congress Party,1129,2,1131,0.63,101
3,4,Subash Singh,Bharatiya Janata Party,77337,454,77791,43.49,101
4,5,Abdul Salam,"Jan Sangharsh Dal,",2440,10,2450,1.37,101
5,6,Imteyaz Alam,Rashtriya Republican Party,378,0,378,0.21,101
6,7,Chandan Singh,Hindu Samaj Party,331,1,332,0.19,101
7,8,Pramod Kumar,Gondvana Gantantra Party,564,7,571,0.32,101
8,9,Mithilesh Kumar Gupta,Jan Adhikar Party (Loktantrik),526,5,531,0.3,101
9,10,Motilal Prasad,Apna Kisan Party,544,1,545,0.3,101
10,11,Raju Kumar Yadav,Janata Party,720,7,727,0.41,101
11,12,Binay Kumar,All India Forward Bloc,1164,9,1173,0.66,101
12,13,Vivek Kumar Chaubey,The Plurals Party,2155,10,2165,1.21,101
13,14,Md. Hayatullah,Bhartiya Insan Party,848,1,849,0.47,101
14,15,Rajeev Kumar,Independent,1357,3,1360,0.76,101
15,16,Lalan Prasad Bind,Independent,2417,1,2418,1.35,101
16,17,Waqar Ahmad,Independent,2269,8,2277,1.27,101
17,18,Shambhu Singh,Independent,1136,7,1143,0.64,101
18,19,Sheoji Prasad,Independent,799,10,809,0.45,101
19,20,Sanjay Kumar Prasad,Independent,1230,4,1234,0.69,101
20,21,Sanjay Choubey,Independent,2006,9,2015,1.13,101
21,22,Sunita Sharma,Independent,434,2,436,0.24,101
22,23,NOTA,None of the Above,1014,14,1028,0.57,101
0,1,AMRENDRA KUMAR PANDEY,Janata Dal (United),74198,161,74359,41.19,102
1,2,KALI PRASAD PANDEY,Indian National Congress,53445,284,53729,29.76,102
2,3,RAVI PANDEY,Lok Jan Shakti Party,2221,5,2226,1.23,102
3,4,SUNITA DEVI,Rashtriya Lok Samta Party,33454,79,33533,18.57,102
4,5,ESUV ANWAR,Bhartiya Jan Nayak Party,824,2,826,0.46,102
5,6,MOJAHID RAJA,Bahujan Mukti Party,347,0,347,0.19,102
6,7,VINAY RAI,Hindu Samaj Party,335,1,336,0.19,102
7,8,VISHWAKARMA SHARMA,Apna Kisan Party,652,2,654,0.36,102
8,9,AJEET KUMAR CHAUBEY,Independent,531,0,531,0.29,102
9,10,SADMAN ALI,Independent,811,0,811,0.45,102
10,11,SUDHANSHU KUMAR PANDEY,Independent,1680,1,1681,0.93,102
11,12,SUNIL KUMAR JAYSAWAL,Independent,1153,1,1154,0.64,102
12,13,HARI NARAYAN SINGH,Independent,2686,1,2687,1.49,102
13,14,NOTA,None of the Above,7652,4,7656,4.24,102
0,1,Pushpa Devi,Lok Jan Shakti Party,4449,71,4520,2.47,103
1,2,Sunil Kumar,Janata Dal (United),73550,517,74067,40.5,103
2,3,Ajay Kumar Bharti,Bhartiya Jan Nayak Party,3679,7,3686,2.02,103
3,4,Jitendra Kumar Ram,Bahujan Mukti Party,1305,12,1317,0.72,103
4,5,Jitendra Paswan,Communist Party of India  (Marxist-Leninist)  (Liberation),72524,1081,73605,40.25,103
5,6,Bishal Kumar Bharti,The Plurals Party,3345,7,3352,1.83,103
6,7,Manoj Kumar Baitha,Jan Adhikar Party (Loktantrik),4284,44,4328,2.37,103
7,8,Rinki Devi,"Jan Sangharsh Dal,",3305,3,3308,1.81,103
8,9,Vinod Baitha,Shiv Sena,1307,2,1309,0.72,103
9,10,Jitendra Ram,Independent,1788,2,1790,0.98,103
10,11,Dularchand Ram,Independent,3566,3,3569,1.95,103
11,12,NOTA,None of the Above,7997,13,8010,4.38,103
0,1,Rajesh Kumar Singh,Rashtriya Janata Dal,86257,474,86731,49.84,104
1,2,Ram Darshan Prasad,Lok Jan Shakti Party,9870,24,9894,5.69,104
2,3,Ramsewak Singh,Janata Dal (United),56020,184,56204,32.29,104
3,4,Sabib Alam,Nationalist Congress Party,748,1,749,0.43,104
4,5,Surendra Ram S/O Kanhaiya Ram,Bahujan Samaj Party,3377,15,3392,1.95,104
5,6,Abhinandan Pathak,Vanchit Samaj Party,470,2,472,0.27,104
6,7,Indrajit Gupt Jyotishkar,Rashtriya Jan-Jagran Morcha,304,1,305,0.18,104
7,8,Kashinath Singh,Janata Party,360,3,363,0.21,104
8,9,Mohammad` Mustafa,Bahujan Mukti Party,510,1,511,0.29,104
9,10,Surendra Ram S/O Late Chanderdeo Ram,Bhartiya Rashtriya Dal,676,2,678,0.39,104
10,11,Maksudan Prasad Singh,Independent,1103,0,1103,0.63,104
11,12,Raj Kumar Srivastav,Independent,849,2,851,0.49,104
12,13,Dr Shashi Bhushan Rai,Independent,1803,0,1803,1.04,104
13,14,Shreeram Bhagat,Independent,4135,0,4135,2.38,104
14,15,Surendra Gupta,Independent,2340,3,2343,1.35,104
15,16,NOTA,None of the Above,4495,6,4501,2.59,104
0,1,AQUIL AHMAD RAHI,Nationalist Congress Party,788,3,791,0.47,105
1,2,ABDUL RIZWAN ANSARI,Rashtriya Lok Samta Party,2326,12,2338,1.38,105
2,3,AWADH BIHARI CHAUDHARY,Rashtriya Janata Dal,76052,733,76785,45.3,105
3,4,OM PRAKASH YADAV,Bharatiya Janata Party,74491,321,74812,44.13,105
4,5,ANIL KUMAR VERMA,Rashtriya Manav Sewa Party,896,2,898,0.53,105
5,6,RAMESHWAR KUMAR,The Plurals Party,1531,21,1552,0.92,105
6,7,ABHISHEK SRIVASTVA alias SONU,Independent,226,2,228,0.13,105
7,8,KAUSHAL KISHORE YADAV,Independent,228,2,230,0.14,105
8,9,DEVENDRA GUPTA,Independent,1428,8,1436,0.85,105
9,10,NEMATULLAH KHAN,Independent,1573,9,1582,0.93,105
10,11,MOHAMMAD MITHU SAH,Independent,651,1,652,0.38,105
11,12,RAJAN KUMAR,Independent,2345,1,2346,1.38,105
12,13,VINOD KUMAR SRIVASTAVA,Independent,2578,4,2582,1.52,105
13,14,VYASDEO PRASAD,Independent,1851,20,1871,1.1,105
14,15,NOTA,None of the Above,1412,4,1416,0.84,105
0,1,Kamala Singh,Janata Dal (United),43804,128,43932,30.44,106
1,2,Rahul Dravid,Bahujan Samaj Party,1012,4,1016,0.7,106
2,3,Binod Tiwari,Lok Jan Shakti Party,7112,43,7155,4.96,106
3,4,Achchhelal Kumar God,Swatantra Samaj Party,1029,3,1032,0.71,106
4,5,Amarjeet Kushwaha,Communist Party of India  (Marxist-Leninist)  (Liberation),68960,482,69442,48.11,106
5,6,Mahatma Singh,Janata Party,1732,6,1738,1.2,106
6,7,Markandey Kumar Upadhyay Alias Bullet Baba,The Plurals Party,793,2,795,0.55,106
7,8,Ugam Pathak,Independent,4907,36,4943,3.42,106
8,9,Kumar Santosh,Independent,2499,0,2499,1.73,106
9,10,Dhanu Prasad,Independent,889,2,891,0.62,106
10,11,Rakesh Kumar Pandey,Independent,1339,8,1347,0.93,106
11,12,Shri Niwas Yadav,Independent,4805,11,4816,3.34,106
12,13,NOTA,None of the Above,4735,4,4739,3.28,106
0,1,RAMAYAN MANJHI,Bharatiya Janata Party,68678,270,68948,42.95,107
1,2,KUMAR SHASHI RANJAN,The Plurals Party,2512,9,2521,1.57,107
2,3,SATYADEO RAM,Communist Party of India  (Marxist-Leninist)  (Liberation),80449,618,81067,50.5,107
3,4,SHEO KUMAR MANJHI,Independent,3124,16,3140,1.96,107
4,5,NOTA,None of the Above,4857,6,4863,3.03,107
0,1,Manoj Kumar Singh,Lok Jan Shakti Party,49623,169,49792,31.35,108
1,2,Rajeshwar Chauhan,Janata Dal (United),26084,78,26162,16.47,108
2,3,Vinay Kumar Pandey,Bahujan Samaj Party,5272,23,5295,3.33,108
3,4,Harishankar Yadav,Rashtriya Janata Dal,67201,556,67757,42.66,108
4,5,Mohamad Kaif Samsir,SOCIAL DEMOCRATIC PARTY OF INDIA,5171,8,5179,3.26,108
5,6,NOTA,None of the Above,4653,2,4655,2.93,108
0,1,KARNJEET SINGH ALIAS VYAS SINGH,Bharatiya Janata Party,71654,280,71934,44.09,109
1,2,AMARNATH YADAV,Communist Party of India  (Marxist-Leninist)  (Liberation),60162,452,60614,37.15,109
2,3,ANAND KUMAR SINGH,Jai Maha Bharath Party,2017,2,2019,1.24,109
3,4,BEBI PANDEY,Bhartiya Lok Nayak Party,529,6,535,0.33,109
4,5,RAMA GANESH SHYAM,Suheldev Bharatiya Samaj Party,492,2,494,0.3,109
5,6,SHAILENDRA KUMAR YADAV,Jan Adhikar Party (Loktantrik),3432,21,3453,2.12,109
6,7,AJEET KUMAR ALIAS BIHARI LAL,Independent,594,0,594,0.36,109
7,8,KAUSHLENDRA SINGH ALIAS K.K. SINGH,Independent,2996,8,3004,1.84,109
8,9,RAJESH GIRI,Independent,1081,2,1083,0.66,109
9,10,ROHIT KUMAR ANURAG ALIAS BHOLA JI,Independent,10276,23,10299,6.31,109
10,11,LAICHI BANSAFOR,Independent,3676,0,3676,2.25,109
11,12,NOTA,None of the Above,5456,2,5458,3.35,109
0,1,BACHCHA PANDEY,Rashtriya Janata Dal,71226,567,71793,41.62,110
1,2,BANDANA DEVI,Rashtriya Lok Samta Party,4819,18,4837,2.8,110
2,3,BIRBAHADUR SINGH,Lok Jan Shakti Party,5040,25,5065,2.94,110
3,4,SHYAMBAHADUR SINGH,Janata Dal (United),68006,228,68234,39.55,110
4,5,ASHOK KUMAR KUSHWAHA,Apna Kisan Party,1208,3,1211,0.7,110
5,6,MUMTAJ ALAM,Bhartiya Panchyat Party,894,0,894,0.52,110
6,7,ANIL KUMAR GIRI,Independent,1591,6,1597,0.93,110
7,8,DR. ASHRAF ALI,Independent,2690,20,2710,1.57,110
8,9,UMESH KUMAR SINGH,Independent,562,2,564,0.33,110
9,10,MD. TAUSIF,Independent,848,3,851,0.49,110
10,11,MANTU KUMAR,Independent,1505,0,1505,0.87,110
11,12,MUZAFFER IMAM,Independent,3311,1,3312,1.92,110
12,13,RANJEET KUMAR SINGH,Independent,3004,1,3005,1.74,110
13,14,RIZWAN AHMAD,Independent,2697,2,2699,1.56,110
14,15,NOTA,None of the Above,4229,2,4231,2.45,110
0,1,DEVESH KANT SINGH,Bharatiya Janata Party,87192,176,87368,45.66,111
1,2,NUTAN DEVI,Rashtriya Janata Dal,74847,630,75477,39.45,111
2,3,RAVINDRA PANDEY,Nationalist Congress Party,917,3,920,0.48,111
3,4,SATYADEO PRASAD SINGH,Rashtriya Lok Samta Party,1670,13,1683,0.88,111
4,5,AKHILESHWAR MISHRA,Bhartiya Sablog Party,274,3,277,0.14,111
5,6,EMTAJ MIYAN,Bhartiya Insan Party,188,1,189,0.1,111
6,7,JITESH KUMAR SINGH,The Plurals Party,327,0,327,0.17,111
7,8,PRAMOD KUMAR SAHWAL,Jagrook Janta Party,207,0,207,0.11,111
8,9,PARMOD RAI,Janata Party,670,2,672,0.35,111
9,10,PREMCHAND SINGH,Jan Adhikar Party (Loktantrik),1764,3,1767,0.92,111
10,11,RAMAYAN SINGH,All India Forward Bloc,377,0,377,0.2,111
11,12,VINAY KUMAR BHARDWAJ,Jawan Kisan Morcha,560,1,561,0.29,111
12,13,SANJAY SINGH,Rashtrawadi Janlok Party (Satya),435,0,435,0.23,111
13,14,ANUP KUMAR TEWARI,Independent,2366,11,2377,1.24,111
14,15,ARAVIND KUMAR SINGH,Independent,5219,4,5223,2.73,111
15,16,ASHOK KUMAR VARMA,Independent,4101,3,4104,2.14,111
16,17,KAUNAIN AHAMAD,Independent,3132,4,3136,1.64,111
17,18,JAWAHER SAH,Independent,1585,0,1585,0.83,111
18,19,TRIBHUWAN RAM,Independent,1394,3,1397,0.73,111
19,20,DHARAMBEER SINGH,Independent,544,0,544,0.28,111
20,21,MANOJ KUMAR SINGH,Independent,293,0,293,0.15,111
21,22,RAMAYAN YADAV,Independent,291,9,300,0.16,111
22,23,LALBABU SHARMA,Independent,320,0,320,0.17,111
23,24,SHEKH IMAM HUSSAIN,Independent,681,0,681,0.36,111
24,25,NOTA,None of the Above,1121,0,1121,0.59,111
0,1,AJIT Prasad,Rashtriya Lok Samta Party,4973,10,4983,3.07,112
1,2,Dr. Deo Ranjan Singh,Lok Jan Shakti Party,18190,88,18278,11.26,112
2,3,Vijay Shanker Dubey,Indian National Congress,48349,476,48825,30.07,112
3,4,HARI KISHOR PRASAD,Nationalist Congress Party,1173,6,1179,0.73,112
4,5,HEM NARAYAN SAH,Janata Dal (United),46711,138,46849,28.86,112
5,6,Abhinaw Kumar Pandey,Rashtriya Manav Sewa Party,1374,2,1376,0.85,112
6,7,Abhishek Kumar,Rashtriya Jan Jan Party,1068,4,1072,0.66,112
7,8,UMA SHANKAR TIWARI,All India Forward Bloc,515,0,515,0.32,112
8,9,Ejaz Ahmad Siddique,Azad Samaj Party,7684,30,7714,4.75,112
9,10,Kamakhya Narain Singh,Janata Party,2116,6,2122,1.31,112
10,11,JITENDRA KUMAR,Sarvajan Hitay Party,828,0,828,0.51,112
11,12,Nayan Prasad,Bharat Ka Kisan Majdoor Party,1698,1,1699,1.05,112
12,13,RAJIV KUMAR URPH GANDHI JEE,Rashtriya Sahyog Party,1740,1,1741,1.07,112
13,14,BISHWANATH YADAEO,Jan Adhikar Party (Loktantrik),3391,2,3393,2.09,112
14,15,Shree Bhagwan Singh,Janvadi Party(Socialist),1629,2,1631,1,112
15,16,SATYENDRA KUMAR GANDHI,Janta Dal Rashtravadi,2146,0,2146,1.32,112
16,17,SURENDRA KUMAR YADAV,Rashtriya Jansambhavna Party,1143,1,1144,0.7,112
17,18,AMIT KUMAR,Independent,1477,2,1479,0.91,112
18,19,OM PRAKASH SHARMA,Independent,2182,3,2185,1.35,112
19,20,KRISHNANAND TYAGI,Independent,552,0,552,0.34,112
20,21,Khadim Hussain,Independent,1845,4,1849,1.14,112
21,22,DHARMENDRA MAHATO,Independent,1944,4,1948,1.2,112
22,23,Manoranjan Kumar Singh,Independent,1094,5,1099,0.68,112
23,24,Ravindr Kumar,Independent,807,0,807,0.5,112
24,25,VISHWAMBHAR SINGH,Independent,1538,0,1538,0.95,112
25,26,Shambhu Nath Suropam,Independent,1304,0,1304,0.8,112
26,27,SUSHIL KUMAR DABLU,Independent,1614,10,1624,1,112
27,28,NOTA,None of the Above,2469,4,2473,1.52,112
0,1,KAMESHWAR KU SINGH,Lok Jan Shakti Party,29750,242,29992,19.51,113
1,2,KUSHVAHA RAJBAL SINGH,Rashtriya Lok Samta Party,2993,18,3011,1.96,113
2,3,SRIKANT YADAV,Rashtriya Janata Dal,53394,481,53875,35.05,113
3,4,SITA DEVI,Janata Dal (United),39711,237,39948,25.99,113
4,5,LAKSHMAN SINGH,Jan Adhikar Party (Loktantrik),1453,2,1455,0.95,113
5,6,NARENDRA PRATAP MISHRA,Independent,2881,9,2890,1.88,113
6,7,MANISH MANORANJAN,Independent,815,3,818,0.53,113
7,8,MANOJ KUMAR SHARMA,Independent,1110,2,1112,0.72,113
8,9,RANJEET SINGH,Independent,10972,26,10998,7.16,113
9,10,RAHULKUMAR SAH,Independent,3177,2,3179,2.07,113
10,11,SRIRAM CHAUDHARI,Independent,1874,0,1874,1.22,113
11,12,NOTA,None of the Above,4541,4,4545,2.96,113
0,1,OM PRAKASH PRASAD,Rashtriya Lok Samta Party,10040,69,10109,6.4,114
1,2,KAMAL NAYAN PATHAK,Nationalist Congress Party,571,20,591,0.37,114
2,3,MADHAVI KUMARI,Janata Dal (United),28855,300,29155,18.46,114
3,4,Dr. Satyendra Yadav,Communist Party of India  (Marxist),58863,461,59324,37.56,114
4,5,SAURABH KUMAR PANDEY,Lok Jan Shakti Party,3680,45,3725,2.36,114
5,6,RAVI RANJAN SINGH,Rashtriya Jan Jan Party,1657,15,1672,1.06,114
6,7,RAJ KUMAR TIWARI,Bharatiya Jan Kranti Dal (Democratic),759,3,762,0.48,114
7,8,SHAIKH NAUSHAD,Aazad Samaj Party (Kanshi Ram),983,10,993,0.63,114
8,9,ATUL BHASKAR,Independent,882,4,886,0.56,114
9,10,VINOD KUMAR MANJHI,Independent,762,3,765,0.48,114
10,11,RANA PRATAP SINGH,Independent,33709,229,33938,21.49,114
11,12,RAM NARAYAN YADAV,Independent,1560,1,1561,0.99,114
12,13,VIJAY PRATAP SINGH,Independent,7348,26,7374,4.67,114
13,14,SHANKAR SHARMA,Independent,2344,1,2345,1.48,114
14,15,SUJIT PURI,Independent,1354,1,1355,0.86,114
15,16,SAURABH SUNNY,Independent,2467,2,2469,1.56,114
16,17,NOTA,None of the Above,900,6,906,0.57,114
0,1,KEDAR NATH SINGH,Rashtriya Janata Dal,64448,746,65194,38.74,115
1,2,TARKESHWAR SINGH,Lok Jan Shakti Party,32945,137,33082,19.66,115
2,3,NAWAL KISHOR KUSHWAHA,Bahujan Samaj Party,1707,19,1726,1.03,115
3,4,ANIL KUMAR RAM,Janta Dal Rashtravadi,1871,11,1882,1.12,115
4,5,KAMESHWAR BAITHA,Jan Adhikar Party (Loktantrik),1068,3,1071,0.64,115
5,6,CHIKI SINGH,The Plurals Party,1146,10,1156,0.69,115
6,7,VIRENDRA KUMAR OJHA,Vikassheel Insaan Party,37229,176,37405,22.23,115
7,8,DABLU KUMAR,Independent,2122,2,2124,1.26,115
8,9,NARAYAN PD. YADAW,Independent,2033,6,2039,1.21,115
9,10,PUSHPA KUMARI,Independent,2387,8,2395,1.42,115
10,11,MADAN SINGH,Independent,921,3,924,0.55,115
11,12,SUDHIR KUMAR,Independent,2151,6,2157,1.28,115
12,13,SUMIT KUMAR GUPTA,Independent,12461,24,12485,7.42,115
13,14,NOTA,None of the Above,4656,1,4657,2.77,115
0,1,Janak Singh,Bharatiya Janata Party,53275,155,53430,32.15,116
1,2,Shaukat Ali,Bahujan Samaj Party,1744,9,1753,1.05,116
2,3,Sipahi Lal Mahto,Rashtriya Janata Dal,41733,390,42123,25.35,116
3,4,Ranjay Kumar Singh,Shiv Sena,1066,2,1068,0.64,116
4,5,Raj Kishore Prasad,Peoples Party of India (Democratic),766,0,766,0.46,116
5,6,Rana Partap Singh,All India Forward Bloc,373,1,374,0.23,116
6,7,Sanjay Kumar Singh,Jan Adhikar Party (Loktantrik),513,2,515,0.31,116
7,8,Aman Anand,Independent,461,3,464,0.28,116
8,9,Chandni Devi,Independent,562,1,563,0.34,116
9,10,Dhananjay Kumar Singh,Independent,1464,6,1470,0.88,116
10,11,Braj Bihari Singh,Independent,622,0,622,0.37,116
11,12,Mithilesh Kumar,Independent,9017,22,9039,5.44,116
12,13,Mudrika Prasad Roy,Independent,7265,24,7289,4.39,116
13,14,Satrudhan Singh,Independent,4507,3,4510,2.71,116
14,15,SHAILENDRA PRATAP,Independent,13939,56,13995,8.42,116
15,16,Saroj Kumar Giri,Independent,11523,27,11550,6.95,116
16,17,Sudhir Kumar Singh,Independent,15301,124,15425,9.28,116
17,18,NOTA,None of the Above,1225,4,1229,0.74,116
0,1,ALTAF ALAM,Janata Dal (United),48205,222,48427,31.93,117
1,2,ASHWANI KUMAR,Bahujan Samaj Party,2622,16,2638,1.74,117
2,3,JITENDRA KUMAR RAY,Rashtriya Janata Dal,59171,641,59812,39.44,117
3,4,VINAY KUMAR,Lok Jan Shakti Party,6527,23,6550,4.32,117
4,5,Abhishek Kumar Singh,Rashtriya General Party,993,1,994,0.66,117
5,6,AMRITESH KUMAR SINGH,Rashtriya Jan Jan Party,940,15,955,0.63,117
6,7,EHASAN AHMAD,SOCIAL DEMOCRATIC PARTY OF INDIA,879,5,884,0.58,117
7,8,JAI RAM RAY,Janta Dal Rashtravadi,555,0,555,0.37,117
8,9,RAJEEV RANJAN,Bhartiya Sablog Party,1246,6,1252,0.83,117
9,10,SHAMBHU PD. SINGH,Janata Party,986,9,995,0.66,117
10,11,ASHOK SHARMA,Independent,633,2,635,0.42,117
11,12,ANAND KUMAR RAI,Independent,3099,9,3108,2.05,117
12,13,GANPATI PRASAD GAURAV,Independent,1202,0,1202,0.79,117
13,14,CHANDESHWAR CHOUDHARY,Independent,3328,1,3329,2.19,117
14,15,NAGENDRA RAY,Independent,4436,9,4445,2.93,117
15,16,PANKAJ KUMAR,Independent,3512,0,3512,2.32,117
16,17,PRABHAT KUMAR GIRI,Independent,1729,2,1731,1.14,117
17,18,BULINDER D YADAV,Independent,640,1,641,0.42,117
18,19,LAL BABU RAY,Independent,6299,24,6323,4.17,117
19,20,LALU PRASAD YADAV,Independent,817,1,818,0.54,117
20,21,Santosh Kumar Ray,Independent,864,1,865,0.57,117
21,22,SANDEV KUMAR RAY,Independent,467,1,468,0.31,117
22,23,NOTA,None of the Above,1518,7,1525,1.01,117
0,1,DR. C. N. GUPTA,Bharatiya Janata Party,75135,575,75710,44.97,118
1,2,MANOJ MAHATO,Bahujan Samaj Party,2893,16,2909,1.73,118
2,3,RANDHIR KUMAR SINGH,Rashtriya Janata Dal,67913,1026,68939,40.95,118
3,4,DHARMENDRA PANDEY,Rashtriya Manav Sewa Party,958,0,958,0.57,118
4,5,MANORANJAN KUMAR SHRIVASTVA,Pragatisheel Janta Party,278,4,282,0.17,118
5,6,MOHAMMAD SALIM,Bharatiya Momin Front,232,4,236,0.14,118
6,7,UMESHWAR SINGH,Independent,490,8,498,0.3,118
7,8,PARMESHWAR KUMAR,Independent,236,2,238,0.14,118
8,9,BIRENDRA SAH,Independent,1014,8,1022,0.61,118
9,10,MOHAMMAD ASGAR ALI,Independent,367,6,373,0.22,118
10,11,YOGENDRA RAY,Independent,396,3,399,0.24,118
11,12,DR. VIJAYA RANI SINGH,Independent,1157,9,1166,0.69,118
12,13,VINOD KUMAR TIWARI,Independent,710,2,712,0.42,118
13,14,SANJEEV KUMAR SINGH,Independent,3729,15,3744,2.22,118
14,15,SUNIL KUMAR,Independent,6037,25,6062,3.6,118
15,16,SUBHASH RAY,Independent,3190,3,3193,1.9,118
16,17,NOTA,None of the Above,1899,21,1920,1.14,118
0,1,GYANCHAND MANJHI,Bharatiya Janata Party,73128,347,73475,41.59,119
1,2,SABITA DEVI,Bahujan Samaj Party,2241,6,2247,1.27,119
2,3,SURENDRA RAM,Rashtriya Janata Dal,82874,538,83412,47.21,119
3,4,BARUN KUMAR DAS,Peoples Party of India (Democratic),1382,2,1384,0.78,119
4,5,MUNESHWAR CHOUDHARY,Jan Adhikar Party (Loktantrik),4367,52,4419,2.5,119
5,6,SANTOSH MANJHI,Proutist Sarva Samaj,557,0,557,0.32,119
6,7,NIRAJ RAM,Independent,785,3,788,0.45,119
7,8,PUJA KUMARI,Independent,955,4,959,0.54,119
8,9,BIGAN MANJHI,Independent,2874,0,2874,1.63,119
9,10,SHIV PRASAD MANJHI,Independent,2674,7,2681,1.52,119
10,11,NOTA,None of the Above,3863,11,3874,2.19,119
0,1,Krishan Kumar Mantoo,Bharatiya Janata Party,62995,321,63316,42.29,120
1,2,Rahul Kumar,Rashtriya Lok Samta Party,4766,17,4783,3.19,120
2,3,Sunil Kumar,Rashtriya Janata Dal,59171,464,59635,39.83,120
3,4,Nurjaha,Bharatiya Momin Front,911,3,914,0.61,120
4,5,Poonam Rai,Jan Adhikar Party (Loktantrik),438,0,438,0.29,120
5,6,Vir Kunwar Singh,Sarva Samaj Janata Party,194,1,195,0.13,120
6,7,Krishna Mishra,Independent,242,0,242,0.16,120
7,8,Jitendra Kumar Singh,Independent,530,2,532,0.36,120
8,9,Nand Kishor Singh,Independent,1049,3,1052,0.7,120
9,10,Bikash Kumar,Independent,326,1,327,0.22,120
10,11,Ram Pukar Mehata,Independent,1536,2,1538,1.03,120
11,12,Shatrudhan Tiwari,Independent,7438,55,7493,5,120
12,13,Sangeeta Singh,Independent,3909,0,3909,2.61,120
13,14,Sudish Kumar Singh,Independent,1667,1,1668,1.11,120
14,15,NOTA,None of the Above,3667,2,3669,2.45,120
0,1,CHANDRIKA ROY,Janata Dal (United),50799,224,51023,33.13,121
1,2,CHHOTE LAL RAY,Rashtriya Janata Dal,67746,570,68316,44.36,121
2,3,RAKESH KUMAR SINGH,Lok Jan Shakti Party,12137,49,12186,7.91,121
3,4,AKHILESH KUMAR,The Plurals Party,1172,2,1174,0.76,121
4,5,RAMESH KUMAR RAI,Jagrook Janta Party,488,0,488,0.32,121
5,6,SHAILENDRA KUMAR,Jan Adhikar Party (Loktantrik),2353,10,2363,1.53,121
6,7,MAHESH RAY,Independent,4107,12,4119,2.67,121
7,8,MANAGER SINGH,Independent,4541,17,4558,2.96,121
8,9,SANDHYA RAY,Independent,2032,6,2038,1.32,121
9,10,SWAMI JEETENDRA,Independent,2549,1,2550,1.66,121
10,11,NOTA,None of the Above,5172,7,5179,3.36,121
0,1,DHARAMVEER KUMAR,Nationalist Congress Party,1599,4,1603,0.94,122
1,2,DR. RAMANUJ PRASAD,Rashtriya Janata Dal,72804,443,73247,43.11,122
2,3,VINAY KUMAR SINGH,Bharatiya Janata Party,66247,314,66561,39.18,122
3,4,HARISHANKAR KUMAR,Rashtriya Lok Samta Party,1164,4,1168,0.69,122
4,5,ANIL KUMAR SINGH,Samajwadi Janata Dal Democratic,401,2,403,0.24,122
5,6,ASHA KUMARI,The Plurals Party,903,9,912,0.54,122
6,7,RAJEEV RANJAN,Akhand Bhartiya Yuva Party,260,0,260,0.15,122
7,8,SUVODH KUMAR,Sanyukt Vikas Party,313,0,313,0.18,122
8,9,AMOD GOP,Independent,1149,0,1149,0.68,122
9,10,CHANDAN LAL,Independent,8652,15,8667,5.1,122
10,11,PINKI KUMARI PRASAD,Independent,1938,4,1942,1.14,122
11,12,BAIJNATH RAM,Independent,481,4,485,0.29,122
12,13,RAMESH KUMAR,Independent,5524,17,5541,3.26,122
13,14,SUMAN KUMAR,Independent,3051,4,3055,1.8,122
14,15,HEM NARAYAN SINGH,Independent,3042,2,3044,1.79,122
15,16,NOTA,None of the Above,1542,4,1546,0.91,122
0,1,Awadhesh Singh,Bharatiya Janata Party,85351,201,85552,44.55,123
1,2,Kamal Pd Singh,Rashtriya Lok Samta Party,3081,8,3089,1.61,123
2,3,Deo Kumar Chaurasia,Rashtriya Janata Dal,82103,459,82562,42.99,123
3,4,Azim Ansari,Bharatiya Momin Front,872,2,874,0.46,123
4,5,Indradeo Roy,SOCIALIST UNITY CENTRE OF INDIA (COMMUNIST),262,0,262,0.14,123
5,6,Manish Kumar Singh,Bahujan Nyay Dal,217,2,219,0.11,123
6,7,Yashwant Singh,All India Forward Bloc,704,0,704,0.37,123
7,8,Ramanand Singh,Shoshit Samaj Dal,261,2,263,0.14,123
8,9,Vidya Bhushan,Sapaks Party,303,0,303,0.16,123
9,10,Shiv Ranjan Kumar,Rashtriya Jan Jan Party,534,2,536,0.28,123
10,11,Sadu Bhagat,Rashtriya Jansambhavna Party,864,0,864,0.45,123
11,12,Sunil Ray,Janata Party,633,1,634,0.33,123
12,13,Ajit Kumar,Independent,5211,31,5242,2.73,123
13,14,Kishor Kumar,Independent,2487,0,2487,1.3,123
14,15,Krishna Bhagwan,Independent,1517,2,1519,0.79,123
15,16,Dheeraj Kumar Roy,Independent,3175,5,3180,1.66,123
16,17,Nishant Gandhi,Independent,1625,2,1627,0.85,123
17,18,Santosh Kumar Shukla,Independent,370,1,371,0.19,123
18,19,NOTA,None of the Above,1743,2,1745,0.91,123
0,1,Anand Verma,Nationalist Congress Party,863,8,871,0.45,124
1,2,Dinesh Kumar Kushawha,Rashtriya Lok Samta Party,2260,15,2275,1.19,124
2,3,Rakesh Kumar,Indian National Congress,43958,493,44451,23.17,124
3,4,Raj Kumar Sah,Lok Jan Shakti Party,11239,42,11281,5.88,124
4,5,Sanjay Kumar Singh,Bharatiya Janata Party,70571,179,70750,36.88,124
5,6,Azam Hussain,Satya Bahumat Party,1277,1,1278,0.67,124
6,7,Kumari Sneha,Rashtriya Jansambhavna Party,1470,5,1475,0.77,124
7,8,Dilip Thakur,Jan Adhikar Party (Loktantrik),761,2,763,0.4,124
8,9,Mithilesh Kumar Singh Sathi,Sathi Aur Aapka Faisala Party,482,2,484,0.25,124
9,10,Rajendra Sharma,SOCIALIST UNITY CENTRE OF INDIA (COMMUNIST),515,2,517,0.27,124
10,11,Ram Pukar Paswan,Ambedkarite Party of India,1577,0,1577,0.82,124
11,12,Akhilesh Kumar,Independent,2571,0,2571,1.34,124
12,13,Kedar Kumar,Independent,1805,2,1807,0.94,124
13,14,Gauri Shankar Pandey,Independent,5765,19,5784,3.02,124
14,15,Purushottam Kumar Singh,Independent,688,2,690,0.36,124
15,16,Manju Singh,Independent,1773,1,1774,0.92,124
16,17,Manoj Kumar,Independent,618,1,619,0.32,124
17,18,Mahesh Kr. Pandit,Independent,752,5,757,0.39,124
18,19,Mithilesh Kumar,Independent,997,0,997,0.52,124
19,20,Rakesh Paswan,Independent,5110,9,5119,2.67,124
20,21,Rajan Kumar,Independent,2588,1,2589,1.35,124
21,22,Rajeev Kumar Choudhary,Independent,1175,4,1179,0.61,124
22,23,Vijay Kumar Shukla,Independent,27277,183,27460,14.32,124
23,24,Shailendra Kumar Kaushik,Independent,1888,3,1891,0.99,124
24,25,Sanjay Kumar,Independent,1565,8,1573,0.82,124
25,26,NOTA,None of the Above,1282,1,1283,0.67,124
0,1,AJAY KUMAR KUSHWAHA,Lok Jan Shakti Party,33269,82,33351,17.18,125
1,2,SANJEEV SINGH,Indian National Congress,61936,431,62367,32.14,125
2,3,SIDDHARTH PATEL,Janata Dal (United),69565,215,69780,35.96,125
3,4,ARUN KUMAR SINGH,Bhartiya Sablog Party,2180,10,2190,1.13,125
4,5,TARUN SINGH ALIAS PINTOO,Janvadi Party(Socialist),2734,1,2735,1.41,125
5,6,NILESH RANJAN,The Plurals Party,764,2,766,0.39,125
6,7,MUHAMAD AWAS,Jagrook Janta Party,404,2,406,0.21,125
7,8,RAM NATH RAY,SOCIALIST UNITY CENTRE OF INDIA (COMMUNIST),640,4,644,0.33,125
8,9,VINAY PASWAN,Jan Adhikar Party (Loktantrik),890,6,896,0.46,125
9,10,SANJAY KUMAR,Jai Maha Bharath Party,1712,3,1715,0.88,125
10,11,ABHISHEK RAJ,Independent,2858,6,2864,1.48,125
11,12,MITHILESH KUMAR SINGH,Independent,1234,2,1236,0.64,125
12,13,RAJ NARAYAN KUMAR,Independent,4386,0,4386,2.26,125
13,14,SUGANDH KUMAR,Independent,5574,8,5582,2.88,125
14,15,NOTA,None of the Above,5150,5,5155,2.66,125
0,1,ASHMA PARVEEN,Janata Dal (United),48893,0,48893,28.48,126
1,2,MUKESH KUMAR RAUSHAN,Rashtriya Janata Dal,62580,0,62580,36.45,126
2,3,RAVINDRA KUMAR,Rashtriya Lok Samta Party,6335,0,6335,3.69,126
3,4,SANJAY KUMAR SINGH,Lok Jan Shakti Party,25146,0,25146,14.65,126
4,5,JAYNARAYAN SAH,Bajjikanchal Vikas Party,652,0,652,0.38,126
5,6,MD. PARWEZ ALAM,Jan Adhikar Party (Loktantrik),1146,0,1146,0.67,126
6,7,BINOD RAY,Janta Dal Rashtravadi,529,0,529,0.31,126
7,8,BAIDYANATH PRASAD RAY,Bhartiya Rashtriya Dal,1784,0,1784,1.04,126
8,9,RATNESH KUMAR,Right to Recall Party,303,0,303,0.18,126
9,10,RUBI KUMARI,Samta Dal (Pragatisheel),565,0,565,0.33,126
10,11,REYAZ AHMAD,SOCIAL DEMOCRATIC PARTY OF INDIA,999,0,999,0.58,126
11,12,LALIT KUMAR GHOSH,SOCIALIST UNITY CENTRE OF INDIA (COMMUNIST),901,0,901,0.52,126
12,13,VIKASH KUMAR SHARMA,Apna Kisan Party,1939,0,1939,1.13,126
13,14,SUMAN KUMAR SINHA,Bhartiya Party (Loktantrik),2068,0,2068,1.2,126
14,15,AMRESH KUMAR,Independent,2103,0,2103,1.22,126
15,16,ARCHANA KUMARI JHA,Independent,2526,0,2526,1.47,126
16,17,Er. NITISH KUMAR,Independent,1785,0,1785,1.04,126
17,18,NARENDRA GIRI,Independent,1541,0,1541,0.9,126
18,19,NAVIN KUMAR,Independent,505,0,505,0.29,126
19,20,PURAN THAKUR,Independent,1735,0,1735,1.01,126
20,21,VINOD KUMAR,Independent,4888,0,4888,2.85,126
21,22,SHIV NATH SAHNI,Independent,510,0,510,0.3,126
22,23,SEEMA KUMARI,Independent,671,0,671,0.39,126
23,24,NOTA,None of the Above,1595,0,1595,0.93,126
0,1,Dhananjay Kumar,Lok Jan Shakti Party,24556,133,24689,16.22,127
1,2,Pratima Kumari,Indian National Congress,53690,609,54299,35.67,127
2,3,Pharesh Ram,Bahujan Samaj Party,2474,8,2482,1.63,127
3,4,Mahendra Ram,Janata Dal (United),52193,310,52503,34.49,127
4,5,Ashok Kumar Mallik,Jan Adhikar Party (Loktantrik),1516,2,1518,1,127
5,6,Umesh Ram,SOCIALIST UNITY CENTRE OF INDIA (COMMUNIST),405,1,406,0.27,127
6,7,Kanhai Pankaj,Ambedkarite Party of India,960,2,962,0.63,127
7,8,Er. Rajkumar Paswan,Yuva Bihar Sena,476,3,479,0.31,127
8,9,Ramji Bhakata,Janta Dal Rashtravadi,605,0,605,0.4,127
9,10,Savita Devi,Rashtriya Jansambhavna Party,643,1,644,0.42,127
10,11,Amar Paswan,Independent,1470,4,1474,0.97,127
11,12,Prema Devi,Independent,2585,4,2589,1.7,127
12,13,Bedami Devi,Independent,1769,1,1770,1.16,127
13,14,Manohar Kumar,Independent,3854,13,3867,2.54,127
14,15,NOTA,None of the Above,3918,10,3928,2.58,127
0,1,TEJASHWI PRASAD YADAV,Rashtriya Janata Dal,96786,618,97404,48.74,128
1,2,RAKESH RAUSHAN,Lok Jan Shakti Party,24850,97,24947,12.48,128
2,3,SATISH KUMAR,Bharatiya Janata Party,58966,264,59230,29.64,128
3,4,KUMAR SAMEER RAJA YADAV,Jan Adhikar Party (Loktantrik),3406,7,3413,1.71,128
4,5,JAYMALA DEVI,Shiv Sena,324,0,324,0.16,128
5,6,PARAMHANS SINGH URF PARAMHANS KUMAR SINGH,Aam Jan Party (Secular),222,1,223,0.11,128
6,7,RAJESH RAUSHAN,Bahujan Mukti Party,443,6,449,0.22,128
7,8,ARUN RAY,Independent,304,1,305,0.15,128
8,9,NATHU BHAGAT,Independent,350,1,351,0.18,128
9,10,MADHUSUDHAN PASWAN,Independent,406,1,407,0.2,128
10,11,MEGHNATH PASWAN,Independent,557,0,557,0.28,128
11,12,RAJU KUMAR,Independent,1632,0,1632,0.82,128
12,13,RAJESHWAR RAY,Independent,3481,0,3481,1.74,128
13,14,Ramswaroop Ray,Independent,2672,0,2672,1.34,128
14,15,NOTA,None of the Above,4453,5,4458,2.23,128
0,1,UMESH SINGH KUSHWAHA,Janata Dal (United),53580,194,53774,32.54,129
1,2,TRIVENI KUMAR CHOUDHARY,Rashtriya Lok Samta Party,2533,14,2547,1.54,129
2,3,RABINDRA KR. SINGH,Lok Jan Shakti Party,31256,59,31315,18.95,129
3,4,BINA SINGH,Rashtriya Janata Dal,61361,360,61721,37.34,129
4,5,ANNPURNA SINGH,Bhartiya Sablog Party,1460,3,1463,0.89,129
5,6,ARJUN DAS,Bahujan Mukti Party,879,3,882,0.53,129
6,7,BRAJESH KUMAR RAY,Janta Dal Rashtravadi,701,2,703,0.43,129
7,8,MALAYAM KUMAR MANGLAM,Loktantrik Janta Dal,751,0,751,0.45,129
8,9,RAGHUPATI SINGH,Jan Adhikar Party (Loktantrik),1501,6,1507,0.91,129
9,10,RAJNISH PASWAN,The Plurals Party,941,8,949,0.57,129
10,11,SHYAM BABU SINGH,Sathi Aur Aapka Faisala Party,1960,0,1960,1.19,129
11,12,HARERAM KUMAR,Janshakti Vikas Party (Democratic),1839,1,1840,1.11,129
12,13,KARUNA VERMA,Independent,1379,2,1381,0.84,129
13,14,NOTA,None of the Above,4474,7,4481,2.71,129
0,1,DEVLAL RAM,Bahujan Samaj Party,1908,0,1908,1.15,130
1,2,LAKHENDRA KUMAR RAUSHAN,Bharatiya Janata Party,86447,62,86509,52.15,130
2,3,SHASHI KUMAR,Nationalist Congress Party,1760,1,1761,1.06,130
3,4,SHIV CHANDRA RAM,Rashtriya Janata Dal,60489,181,60670,36.57,130
4,5,ANIL PASWAN,Jan Adhikar Party (Loktantrik),876,2,878,0.53,130
5,6,AWANISH,Bahujan Mukti Party,402,2,404,0.24,130
6,7,DHARMENDRA PASWAN,Bharatiya Momin Front,284,0,284,0.17,130
7,8,SHIVJEE RAJAK,The Plurals Party,576,0,576,0.35,130
8,9,SONELAL PASWAN,SOCIALIST UNITY CENTRE OF INDIA (COMMUNIST),490,0,490,0.3,130
9,10,ANIL KUMAR,Independent,567,0,567,0.34,130
10,11,BINDSHWAR RAM,Independent,868,0,868,0.52,130
11,12,SANJAY RAJAK,Independent,2337,0,2337,1.41,130
12,13,SANJAY RAM,Independent,2857,1,2858,1.72,130
13,14,SURENDRA KUMAR PASWAN,Independent,3237,0,3237,1.95,130
14,15,NOTA,None of the Above,2533,0,2533,1.53,130
0,1,A MONA PRASAD SUNDESHWAR RAM,Lok Jan Shakti Party,23140,23,23163,12.32,131
1,2,MAMTA KUMARI,Bahujan Samaj Party,1620,5,1625,0.86,131
2,3,MAHESHWAR HAZARI,Janata Dal (United),72237,42,72279,38.46,131
3,4,Anamika,"Aam Janmat Party,",3719,4,3723,1.98,131
4,5,UMESH DAS,Rashtriya Jan Vikas Party,4327,2,4329,2.3,131
5,6,PRAMILA DEVI,Bhartiya Sablog Party,2019,0,2019,1.07,131
6,7,MANTESH KUMAR,Jan Adhikar Party (Loktantrik),1959,2,1961,1.04,131
7,8,RANJEET KUMAR RAM,Communist Party of India  (Marxist-Leninist)  (Liberation),61908,120,62028,33,131
8,9,SHATRUDHAN PASWAN,Shiv Sena,3302,1,3303,1.76,131
9,10,SANJAY DAS,Yuva Krantikari Party,3875,0,3875,2.06,131
10,11,SHIV NATH SHARAN,Independent,2732,2,2734,1.45,131
11,12,NOTA,None of the Above,6899,0,6899,3.67,131
0,1,Ashok Kumar,Janata Dal (United),68229,127,68356,35.97,132
1,2,Urmila Sinha,Lok Jan Shakti Party,23870,58,23928,12.59,132
2,3,B. K. Singh,Rashtriya Lok Samta Party,7910,22,7932,4.17,132
3,4,Allama Shibli Nomani Hashmi,Janata Party,1307,0,1307,0.69,132
4,5,Upendra Sharama,Rashtriya Jan Jan Party,1371,5,1376,0.72,132
5,6,Kriti King,The Plurals Party,1951,4,1955,1.03,132
6,7,Dinesh Kumar Ray,Bhartiya Lokmat Rashtrwadi Party,787,1,788,0.41,132
7,8,Md. Naushad,Jan Adhikar Party (Loktantrik),3522,5,3527,1.86,132
8,9,Phoolbabu Singh,Communist Party of India  (Marxist-Leninist)  (Liberation),54316,239,54555,28.71,132
9,10,Ram Kumar Sahani,Samajwadi Janata Dal Democratic,1374,5,1379,0.73,132
10,11,Vinay Kumar,Bhartiya Sablog Party,1769,3,1772,0.93,132
11,12,Archana Rani,Independent,1129,2,1131,0.6,132
12,13,Abhinav Raj,Independent,1505,0,1505,0.79,132
13,14,Ashok Ray,Independent,1493,0,1493,0.79,132
14,15,Tanveer Ahmad,Independent,3044,0,3044,1.6,132
15,16,Dilep Roy,Independent,5463,2,5465,2.88,132
16,17,Ramesh Kumar Ray,Independent,3802,3,3805,2,132
17,18,Ramchandra Mahto,Independent,1650,0,1650,0.87,132
18,19,Ram Pukar Thakur,Independent,950,0,950,0.5,132
19,20,Suraj Kumar,Independent,1478,2,1480,0.78,132
20,21,NOTA,None of the Above,2628,4,2632,1.39,132
0,1,Akhtarul Islam Shahin,Rashtriya Janata Dal,68299,208,68507,41.21,133
1,2,Ashwamedh Devi,Janata Dal (United),63711,82,63793,38.37,133
2,3,Mahendra Pradhan,Lok Jan Shakti Party,12064,10,12074,7.26,133
3,4,Sirovan Kumar,Bahujan Samaj Party,728,2,730,0.44,133
4,5,Arvind Kumar,Rashtriya Jan Vikas Party,584,3,587,0.35,133
5,6,Rishikesh Kumar,Bhartiya Sablog Party,342,0,342,0.21,133
6,7,Kanhaiya Kumar,Wazib Adhikar Party,331,0,331,0.2,133
7,8,Kundan Kumar,Shiv Sena,229,1,230,0.14,133
8,9,Premjit Kumar,Aadarsh Mithila Party,530,0,530,0.32,133
9,10,Ranju Devi,Yuva Krantikari Party,246,0,246,0.15,133
10,11,Rajesh Kumar,Bhartiya Lokmat Rashtrwadi Party,261,0,261,0.16,133
11,12,Vinay Kumar Parsad,The Plurals Party,664,1,665,0.4,133
12,13,Saroj Kumar Jha,"Bhartiya Garibmazdoor Party,",447,1,448,0.27,133
13,14,Subodh Kumar Prasad alias Subodh Prasad Sah,"Yug Kranti Dal,",1370,0,1370,0.82,133
14,15,Haroon Gauhar,Janata Party,2673,0,2673,1.61,133
15,16,Avinash Kumar,Independent,4051,2,4053,2.44,133
16,17,Nitesh Kumar Sinha,Independent,2120,0,2120,1.28,133
17,18,Mahindra Ray,Independent,1368,0,1368,0.82,133
18,19,Mahendra Mahto,Independent,859,0,859,0.52,133
19,20,Murari Kumar Singh,Independent,352,0,352,0.21,133
20,21,Ranjan Kishore Sharma,Independent,423,0,423,0.25,133
21,22,Rajeev Ranjan,Independent,367,0,367,0.22,133
22,23,Ramnath Prasad,Independent,540,0,540,0.32,133
23,24,Bishnudev Ram,Independent,195,1,196,0.12,133
24,25,Shiv Kishor Jha,Independent,457,0,457,0.27,133
25,26,Shyam Nandan Prasad,Independent,881,0,881,0.53,133
26,27,NOTA,None of the Above,1835,2,1837,1.11,133
0,1,Alok Kumar Mehta,Rashtriya Janata Dal,90232,369,90601,48.81,134
1,2,Prashant Kumar Pankaj,Rashtriya Lok Samta Party,4329,16,4345,2.34,134
2,3,Sheel Kumar Roy,Bharatiya Janata Party,67222,111,67333,36.27,134
3,4,Santosh Ray,Nationalist Congress Party,1330,2,1332,0.72,134
4,5,Ajay Kumar Jha,Rashtra Sewa Dal,457,2,459,0.25,134
5,6,Md. Kalam,Jantantrik Lokhit Party,461,1,462,0.25,134
6,7,Dilip Kumar Sahani,Lok Shakti Party (Loktantrik),265,0,265,0.14,134
7,8,Pankaj Kumar,Rashtriya Jan Vikas Party,461,0,461,0.25,134
8,9,Prashant Kumar Sonu,"Log Jan Party - Secular,",435,3,438,0.24,134
9,10,Ram Kishor Mahto,Bhartiya Mahasangh Party,289,0,289,0.16,134
10,11,Vineet Kumar,The Plurals Party,593,6,599,0.32,134
11,12,Vinod Kumar Ray,Sathi Aur Aapka Faisala Party,610,1,611,0.33,134
12,13,Baidya Nath Choudhary,Rashtriya Jan Jan Party,1826,2,1828,0.98,134
13,14,Md. Afaque  Ahmad,Independent,2506,0,2506,1.35,134
14,15,Upendra Poddar,Independent,1142,2,1144,0.62,134
15,16,Dinesh Prashad Choudhary,Independent,4575,0,4575,2.46,134
16,17,Nawal Paswan,Independent,4754,5,4759,2.56,134
17,18,Ram Pravesh Ray,Independent,389,1,390,0.21,134
18,19,Vidya Shankar Ray,Independent,1105,1,1106,0.6,134
19,20,Sataya naryan Singh,Independent,1174,0,1174,0.63,134
20,21,NOTA,None of the Above,954,2,956,0.51,134
0,1,ABHAY KUMAR SINGH,Lok Jan Shakti Party,23854,30,23884,14.86,135
1,2,KUMAR ANANT,Rashtriya Lok Samta Party,2480,2,2482,1.54,135
2,3,RANVIJAY SAHU,Rashtriya Janata Dal,59378,176,59554,37.06,135
3,4,VIDYA SAGAR SINGH NISHAD,Janata Dal (United),48828,55,48883,30.42,135
4,5,AMAR KUMAR JHA,Janata Party,1033,3,1036,0.64,135
5,6,MD. IRSHAD,"Bhartiya Garibmazdoor Party,",391,0,391,0.24,135
6,7,UMASHANKAR THAKUR,The Plurals Party,1951,4,1955,1.22,135
7,8,GAUTAM KUMAR,Rashtriya Jan Jan Party,890,0,890,0.55,135
8,9,DILIP KUMAR RAY,Janata Dal  (Secular),574,0,574,0.36,135
9,10,NAVIN SAH,Aam Adhikar Morcha,939,0,939,0.58,135
10,11,MANISH KUMAR,Shiv Sena,464,2,466,0.29,135
11,12,RAM PRAVESH SAHNI,Rashtriya mahan Gantantra Party,946,0,946,0.59,135
12,13,RAMESHWAR RAY,"Log Jan Party - Secular,",2436,2,2438,1.52,135
13,14,RASHMANI KUMAR RAY,Rashtriya Janshakti Party (Secular),2966,1,2967,1.85,135
14,15,SURYANARAYAN SAHNI,Jan Adhikar Party (Loktantrik),1792,1,1793,1.12,135
15,16,JAY KRISHN RAY,Independent,6371,8,6379,3.97,135
16,17,PRANAV KUMAR,Independent,1581,0,1581,0.98,135
17,18,FULENDRA THAKUR,Independent,411,0,411,0.26,135
18,19,MANISH KUMAR MISHRA,Independent,1399,1,1400,0.87,135
19,20,NOTA,None of the Above,1747,0,1747,1.09,135
0,1,ANITA KUMARI,Rashtriya Lok Samta Party,2654,3,2657,1.55,136
1,2,ARBIND KUMAR SAHNI,Rashtriya Janata Dal,68801,241,69042,40.36,136
2,3,ABHASH KUMAR JHA,Lok Jan Shakti Party,11209,15,11224,6.56,136
3,4,VIJAY KUMAR CHOUDHARY,Janata Dal (United),72523,143,72666,42.48,136
4,5,ANIL PURI,Sanyukt Kisan Vikas Party,1514,0,1514,0.89,136
5,6,AMIT KUMAR JHA,Sapaks Party,726,0,726,0.42,136
6,7,NAVIN KUMAR,The Plurals Party,670,2,672,0.39,136
7,8,PUSHPA KUMARI,Shiv Sena,876,1,877,0.51,136
8,9,BULBUL KUMAR SAHNI,Aam Adhikar Morcha,2885,0,2885,1.69,136
9,10,RAM KISHOR CHOUDHARY,Bhartiya Sablog Party,2297,1,2298,1.34,136
10,11,NIKKI JHA,Independent,2289,0,2289,1.34,136
11,12,NOTA,None of the Above,4199,1,4200,2.46,136
0,1,EJYA YADAV,Rashtriya Janata Dal,55107,164,55271,37.31,137
1,2,RAJESH KUMAR SINGH,Bharatiya Janata Party,70302,83,70385,47.51,137
2,3,AJAY KUMAR BULGANIN,Jan Adhikar Party (Loktantrik),5746,6,5752,3.88,137
3,4,ARUN KUMAR RAY,Rashtriya Janshakti Party (Secular),307,0,307,0.21,137
4,5,USHA KIRAN,Janata Party,274,0,274,0.18,137
5,6,GYANESHWAR SINGH,Yuva Krantikari Party,170,0,170,0.11,137
6,7,BHUSHAN PRASAD RAY,Janta Dal Rashtravadi,330,0,330,0.22,137
7,8,RANDHIR BHAI,Rashtrawadi Janlok Party (Satya),489,0,489,0.33,137
8,9,RAJGIR KUMAR ROY,"Bhartiya Garibmazdoor Party,",238,0,238,0.16,137
9,10,RAM NIVAS RAY,Samajwadi Janata Dal Democratic,316,2,318,0.21,137
10,11,RAM MOHAN RAY,Rashtriya Jan Jan Party,418,0,418,0.28,137
11,12,VIRENDRA KUMAR AJAY,Bahujan Mukti Party,956,0,956,0.65,137
12,13,SUBODH KUMAR SINGH,Bhartiya Sablog Party,577,1,578,0.39,137
13,14,ARUN KUMAR SINGH,Independent,3254,1,3255,2.2,137
14,15,DINAKAR PRASAD YADAV,Independent,2567,0,2567,1.73,137
15,16,NAGENDRA SINGH,Independent,2938,0,2938,1.98,137
16,17,MAHENDRA RAY,Independent,1651,1,1652,1.12,137
17,18,VISHWA NATH SAH,Independent,1100,0,1100,0.74,137
18,19,SUDHIR KUMAR RAY,Independent,611,0,611,0.41,137
19,20,NOTA,None of the Above,546,0,546,0.37,137
0,1,Ajay Kumar,Communist Party of India  (Marxist),73580,242,73822,45,138
1,2,CHANDRA BALI THAKUR,Lok Jan Shakti Party,28728,83,28811,17.56,138
2,3,MAMTA KUMARI,Bahujan Samaj Party,1888,5,1893,1.15,138
3,4,Ram Balak Singh,Janata Dal (United),33211,115,33326,20.31,138
4,5,Arun Kumar Ray,Bhartiya Mahasangh Party,1370,2,1372,0.84,138
5,6,Prabhu Narayan Jha,The Plurals Party,549,3,552,0.34,138
6,7,Vijay Kumar Choudhary,Rashtriya Jan Jan Party,1454,5,1459,0.89,138
7,8,Vivekanand Kumar,Bahujan Mukti Party,563,0,563,0.34,138
8,9,Sushant Kumar,"Log Jan Party - Secular,",503,4,507,0.31,138
9,10,Harvind Kumar,Bhartiya Sablog Party,1009,3,1012,0.62,138
10,11,Amarjit Thakur,Independent,1116,1,1117,0.68,138
11,12,Navin Kumar,Independent,1963,3,1966,1.2,138
12,13,Manju Prakash,Independent,6183,24,6207,3.78,138
13,14,Bishwanath Choudhary,Independent,6104,7,6111,3.73,138
14,15,NOTA,None of the Above,5332,1,5333,3.25,138
0,1,KRISHAN RAJ,Lok Jan Shakti Party,22933,62,22995,12.64,139
1,2,NAGENDRA KUMAR VIKAL,Indian National Congress,51164,255,51419,28.27,139
2,3,BIRENDRA KUMAR,Bharatiya Janata Party,86978,185,87163,47.93,139
3,4,VIJAY KUMAR RAM,Bahujan Samaj Party,1663,2,1665,0.92,139
4,5,ASHA DEVI,Aam Adhikar Morcha,575,3,578,0.32,139
5,6,RANDHIR KUMAR PASWAN,The Plurals Party,690,3,693,0.38,139
6,7,VIKRAM RAJAK,Loktantrik Janta Dal,810,0,810,0.45,139
7,8,VIDYA NAND RAM,Wazib Adhikar Party,542,4,546,0.3,139
8,9,SHASHI BHUSHAN DAS,Rashtriya Jan Vikas Party,1312,3,1315,0.72,139
9,10,SHAILENDRA CHAUDHARI,Independent,1646,3,1649,0.91,139
10,11,SHRAWAN KUMAR,Independent,4186,5,4191,2.3,139
11,12,SURENDRA DAS,Independent,3555,1,3556,1.96,139
12,13,NOTA,None of the Above,5282,2,5284,2.91,139
0,1,TEJ PRATAP YADAV,Rashtriya Janata Dal,80822,169,80991,47.27,140
1,2,MANISH KUMAR,Lok Jan Shakti Party,8785,12,8797,5.13,140
2,3,RAJ KUMAR RAY,Janata Dal (United),59783,69,59852,34.93,140
3,4,ARJUN PRASAD YADAV,Jan Adhikar Party (Loktantrik),9864,18,9882,5.77,140
4,5,DILEEP KUMAR MUKHIYA,Aam Adhikar Morcha,940,1,941,0.55,140
5,6,BHANU PANDIT,Rashtriya Jan Vikas Party,2225,2,2227,1.3,140
6,7,VIRENDRA YADAV,Rashtra Sewa Dal,2593,0,2593,1.51,140
7,8,SANJEEV KUMAR,Independent,1626,1,1627,0.95,140
8,9,NOTA,None of the Above,4425,1,4426,2.58,140
0,1,KUMARI MANJU VARMA,Janata Dal (United),27641,97,27738,18.27,141
1,2,RAKHI DEVI,Lok Jan Shakti Party,25297,140,25437,16.76,141
2,3,RAJ VANSHI MAHTO,Rashtriya Janata Dal,68020,615,68635,45.22,141
3,4,RIJWANA KHATOON,Nationalist Congress Party,1105,4,1109,0.73,141
4,5,SUDARSHAN SINGH,Rashtriya Lok Samta Party,10515,76,10591,6.98,141
5,6,ANKUSH KUMAR YADAV,Bhartiya Party (Loktantrik),855,1,856,0.56,141
6,7,AMAN KUMAR,Rashtriya Jan Jan Party,1070,2,1072,0.71,141
7,8,BANWARI PASWAN,Bahujan Mukti Party,525,4,529,0.35,141
8,9,MADHU SHWETA,The Plurals Party,644,6,650,0.43,141
9,10,MAHESH YADAV,Janata Dal  (Secular),554,2,556,0.37,141
10,11,MOHAMMAD TAMANNA,Loktantrik Janta Dal,636,0,636,0.42,141
11,12,SHAMBHU KUMAR SINGH,Bhartiya Sablog Party,1229,1,1230,0.81,141
12,13,RANJEET YADAV,Independent,1492,2,1494,0.98,141
13,14,VATSA PURUSHOTTAM,Independent,3320,1,3321,2.19,141
14,15,SUDAMA PASWAN,Independent,2541,0,2541,1.67,141
15,16,SUBODH KUMAR JHA,Independent,2870,2,2872,1.89,141
16,17,SUMIT KUMAR,Independent,1187,2,1189,0.78,141
17,18,NOTA,None of the Above,1332,3,1335,0.88,141
0,1,ABDHESH KUMAR RAI,Communist Party of India,53808,446,54254,29.94,142
1,2,RANJIT PASWAN,Bahujan Samaj Party,1086,7,1093,0.6,142
2,3,SURENDRA MEHATA,Bharatiya Janata Party,54545,193,54738,30.21,142
3,4,AKHILESH KUMAR,Yuva Krantikari Party,4476,1,4477,2.47,142
4,5,ADILUR REHMAN AZAD,Janta Dal Rashtravadi,541,2,543,0.3,142
5,6,KUNDAN SINGH,Janata Party,443,2,445,0.25,142
6,7,GAUTAM JHA,Jawan Kisan Morcha,352,3,355,0.2,142
7,8,CHANDRADEO SHARMA,Bahujan Mukti Party,352,2,354,0.2,142
8,9,MUKESH KUMAR JHA,Janshakti Vikas Party (Democratic),697,0,697,0.38,142
9,10,LIPI KUMARI,Rashtriya Jan Jan Party,2342,26,2368,1.31,142
10,11,SATYAJEET,The Plurals Party,490,4,494,0.27,142
11,12,AJEET KUMAR RAY,Independent,678,1,679,0.37,142
12,13,INDRA KUMARI,Independent,9655,49,9704,5.36,142
13,14,GAUTAM KUMAR,Independent,2271,0,2271,1.25,142
14,15,DULAR CHAND SAHANI,Independent,3126,5,3131,1.73,142
15,16,RAM NARESH YADAV,Independent,2972,0,2972,1.64,142
16,17,SHIV PRAKASH GARIB DAS,Independent,39648,230,39878,22.01,142
17,18,SATYAM PRAKASH,Independent,865,2,867,0.48,142
18,19,HASSAN,Independent,922,5,927,0.51,142
19,20,NOTA,None of the Above,942,3,945,0.52,142
0,1,BIRENDRA KUMAR,Janata Dal (United),37125,125,37250,21.77,143
1,2,RAM RATAN SINGH,Communist Party of India,84620,609,85229,49.8,143
2,3,LALAN KUMAR,Lok Jan Shakti Party,29777,159,29936,17.49,143
3,4,KEDARNATH BHASKAR,Shoshit Samaj Dal,859,3,862,0.5,143
4,5,CHANDAN KUMAR,Rashtriya Jan Jan Party,824,4,828,0.48,143
5,6,PUNAM DEVI,Janata Dal  (Secular),374,1,375,0.22,143
6,7,PRANAV KUMAR MISHRA,Samta Dal (Pragatisheel),812,2,814,0.48,143
7,8,RAM KRISHAN AMAN,Jai Maha Bharath Party,492,2,494,0.29,143
8,9,RUPAM KUMARI,The Plurals Party,649,9,658,0.38,143
9,10,VIJAY PASWAN,Loktantrik Janshakti Party,479,3,482,0.28,143
10,11,SHRI RAM RAI,Jan Adhikar Party (Loktantrik),1580,2,1582,0.92,143
11,12,ATUL KUMAR,Independent,1025,1,1026,0.6,143
12,13,CHANDAN MAHATO,Independent,3944,1,3945,2.31,143
13,14,SANJIV KUMAR BHARTI,Independent,3915,12,3927,2.29,143
14,15,NOTA,None of the Above,3714,4,3718,2.17,143
0,1,Narendra Kumar Singh @ Bogo Singh,Janata Dal (United),60623,408,61031,29.48,144
1,2,Raj Kumar Singh,Lok Jan Shakti Party,60688,676,61364,29.64,144
2,3,Rajendra Prasad Singh,Communist Party of India  (Marxist),59875,724,60599,29.27,144
3,4,Avinash Kumar,Bahujan Mukti Party,1707,4,1711,0.83,144
4,5,Umesh Patel,Shoshit Samaj Dal,551,2,553,0.27,144
5,6,Dileep Kumar Singh,Jan Adhikar Party (Loktantrik),881,9,890,0.43,144
6,7,Prakash Kumar Urf Murari Singh,Rashtra Sewa Dal,836,3,839,0.41,144
7,8,Bindu Kumari,The Plurals Party,885,8,893,0.43,144
8,9,Amresh Ray,Independent,4359,19,4378,2.11,144
9,10,Amish Kumar,Independent,811,4,815,0.39,144
10,11,Vimalesh Kumar Urf Botal Singh,Independent,1483,1,1484,0.72,144
11,12,Saurabh,Independent,2497,3,2500,1.21,144
12,13,Hemant Kumar,Independent,3258,0,3258,1.57,144
13,14,NOTA,None of the Above,6718,15,6733,3.25,144
0,1,Shashikant Kumar Shashi alias Amar Kumar Singh,Janata Dal (United),50424,239,50663,32.36,145
1,2,Satanand Sambuddha @Lalan,Rashtriya Janata Dal,64270,618,64888,41.45,145
2,3,Surendra Kumar  Alias Surendra Vivek,Lok Jan Shakti Party,22718,153,22871,14.61,145
3,4,Amit Kumar,Angika Samaj Party,819,1,820,0.52,145
4,5,Kaushal Kishor Singh,The Plurals Party,982,5,987,0.63,145
5,6,Gore Lal Ray,All India Majlis-E-Ittehadul Muslimeen,7889,44,7933,5.07,145
6,7,Pravin Kumar,Bahujan Mukti Party,536,1,537,0.34,145
7,8,Rajesh Singh,Aam Jan Party (Secular),798,3,801,0.51,145
8,9,Md. Shahzaduzzama,Independent,1429,0,1429,0.91,145
9,10,Shyamal Prasad Yadav,Independent,1960,2,1962,1.25,145
10,11,NOTA,None of the Above,3664,8,3672,2.35,145
0,1,AMITA BHUSHAN,Indian National Congress,68439,1224,69663,37.23,146
1,2,KUNDAN KUMAR,Bharatiya Janata Party,73831,386,74217,39.66,146
2,3,SANJU KUMARI,Rashtriya Lok Samta Party,5509,22,5531,2.96,146
3,4,ARJUN KUMAR,SOCIALIST UNITY CENTRE OF INDIA (COMMUNIST),338,2,340,0.18,146
4,5,AMARJEET SAH,"Aam Janmat Party,",677,1,678,0.36,146
5,6,DEV KANT SINGH,Jai Prakash Janata Dal,1461,5,1466,0.78,146
6,7,NAND KUMAR SAH,Bahujan Mukti Party,1795,18,1813,0.97,146
7,8,BHASKAR KUMAR,The Plurals Party,902,11,913,0.49,146
8,9,MANOJ KUMAR SINGH,Rashtriya Jan Jan Party,695,12,707,0.38,146
9,10,RAMASHISH  SHARMA,"Log Jan Party - Secular,",526,14,540,0.29,146
10,11,VARUN KUMAR,Shoshit Samaj Dal,511,4,515,0.28,146
11,12,SURYA PRAKASH HISARIYA,Jan Adhikar Party (Loktantrik),674,3,677,0.36,146
12,13,ASHUTOSH KUMAR ALIAS HIRA PODDAR,Independent,1921,15,1936,1.03,146
13,14,DR. MIRA SINGH,Independent,1611,5,1616,0.86,146
14,15,RAJENDRA KUMAR ALIAS RAJA,Independent,3430,8,3438,1.84,146
15,16,RAJESH KUMAR,Independent,17936,66,18002,9.62,146
16,17,SANJAY GAUTAM,Independent,2042,15,2057,1.1,146
17,18,SOHIT TANTI,Independent,2094,2,2096,1.12,146
18,19,NOTA,None of the Above,919,11,930,0.5,146
0,1,AMIT KUMAR,Nationalist Congress Party,1258,3,1261,0.77,147
1,2,RAMSHANKAR PASWAN,Bharatiya Janata Party,71203,197,71400,43.67,147
2,3,VIJAY PASWAN,Rashtriya Lok Samta Party,3834,23,3857,2.36,147
3,4,SURYAKANT PASWAN,Communist Party of India,71642,535,72177,44.14,147
4,5,TULSI TANTI,Shoshit Samaj Dal,2090,4,2094,1.28,147
5,6,MANOJ DAS,Bahujan Mukti Party,581,7,588,0.36,147
6,7,MAHESHWAR RAM,Janata Dal  (Secular),345,1,346,0.21,147
7,8,RAMANAND RAM,Jan Adhikar Party (Loktantrik),1935,11,1946,1.19,147
8,9,LAL BAHADUR PASWAN,Aapki Apni Adhikar Party,381,1,382,0.23,147
9,10,SANJAY KUMAR,The Plurals Party,1277,1,1278,0.78,147
10,11,SATYA PRAKASH,Rashtriya Jan Vikas Party,2394,1,2395,1.46,147
11,12,ANITA DEVI,Independent,1014,2,1016,0.62,147
12,13,RAJESH KUMAR RAJAK,Independent,2450,4,2454,1.5,147
13,14,NOTA,None of the Above,2311,2,2313,1.41,147
0,1,JAGNANDAN SADA,Bahujan Samaj Party,1891,3,1894,1.31,148
1,2,RAM CHANDRA SADA,Lok Jan Shakti Party,26289,97,26386,18.28,148
2,3,RAMVRIKSH SADA,Rashtriya Janata Dal,46806,377,47183,32.69,148
3,4,SADHNA DEVI,Janata Dal (United),44242,168,44410,30.77,148
4,5,AWINASH KUMAR,Janshakti Vikas Party (Democratic),971,3,974,0.67,148
5,6,BODHAN SADA,Jan Adhikar Party (Loktantrik),5585,29,5614,3.89,148
6,7,MONI KUMAR,Bahujan Mukti Party,727,2,729,0.51,148
7,8,RANVEER KUMAR,Aapki Apni Adhikar Party,821,1,822,0.57,148
8,9,RATAN BIHARI,The Plurals Party,766,2,768,0.53,148
9,10,SHYAMSUNDAR RAM,Shoshit Samaj Dal,977,3,980,0.68,148
10,11,SUNIL KUMAR RAJAK,Rashtra Sewa Dal,1256,0,1256,0.87,148
11,12,NILAM DEVI,Independent,2862,4,2866,1.99,148
12,13,RAJESH KUMAR SADA,Independent,5351,2,5353,3.71,148
13,14,WAKIL PASWAN,Independent,2345,3,2348,1.63,148
14,15,NOTA,None of the Above,2765,2,2767,1.92,148
0,1,Chhatrapati Yadav,Indian National Congress,46376,604,46980,31.14,149
1,2,Poonam Devi Yadav,Janata Dal (United),43715,265,43980,29.15,149
2,3,Md Faruque Ahmad,Rashtriya Lok Samta Party,2174,9,2183,1.45,149
3,4,Renu Kumari,Lok Jan Shakti Party,20563,156,20719,13.73,149
4,5,Kripa Sindhu,Rashtriya Jan Jan Party,1340,10,1350,0.89,149
5,6,Jitendra Kumar,SOCIALIST UNITY CENTRE OF INDIA (COMMUNIST),560,2,562,0.37,149
6,7,Pinku Kumari,Bahujan Mukti Party,861,3,864,0.57,149
7,8,Manohar Kumar Yadav,Jan Adhikar Party (Loktantrik),11525,64,11589,7.68,149
8,9,Rajesh Chourasiya,Rashtravadi Janata Party,458,4,462,0.31,149
9,10,Shubhankar Kumar,Angika Samaj Party,588,1,589,0.39,149
10,11,Sanjeev Kumar,The Plurals Party,514,3,517,0.34,149
11,12,Amithav Kumar,Independent,554,1,555,0.37,149
12,13,Alka Kumari,Independent,1449,1,1450,0.96,149
13,14,Uday Shankar,Independent,1012,4,1016,0.67,149
14,15,Gopal Krishan Kumar Chandan,Independent,3158,3,3161,2.1,149
15,16,Jitendra Yadav,Independent,3021,2,3023,2,149
16,17,Er. Dharmendra Kumar,Independent,8506,23,8529,5.65,149
17,18,Raghu Veer Sharma,Independent,683,0,683,0.45,149
18,19,Raj Harsh,Independent,449,2,451,0.3,149
19,20,Shobha Devi,Independent,920,3,923,0.61,149
20,21,Sikandra Azad Vakta,Independent,413,3,416,0.28,149
21,22,NOTA,None of the Above,850,5,855,0.57,149
0,1,Chandan Kumar Alias Dr. Chandan Yadav,Indian National Congress,51064,369,51433,29.06,150
1,2,Panna Lal Singh Patel,Janata Dal (United),56353,188,56541,31.95,150
2,3,Mithilesh Kumar Nishad,Lok Jan Shakti Party,31153,76,31229,17.64,150
3,4,Sushant Yadav,Bahujan Samaj Party,3539,8,3547,2,150
4,5,Afroz Alam,"Log Jan Party - Secular,",576,0,576,0.33,150
5,6,Urmila Devi,Janshakti Vikas Party (Democratic),834,2,836,0.47,150
6,7,Nagendra Singh Tyagi,Jan Adhikar Party (Loktantrik),10545,35,10580,5.98,150
7,8,Ram Balak Ram,Aam Janta Party Rashtriya,887,0,887,0.5,150
8,9,Vidya Nand Yadav,Shoshit Samaj Dal,1116,0,1116,0.63,150
9,10,Suraj Kumar,The Plurals Party,848,6,854,0.48,150
10,11,Soni Devi,Yuva Krantikari Party,634,1,635,0.36,150
11,12,Akhilesh Kumar Vidyarthi,Independent,1002,4,1006,0.57,150
12,13,Ganesh Sada,Independent,2301,2,2303,1.3,150
13,14,Gauri Shankar Paswan,Independent,2874,0,2874,1.62,150
14,15,Priya Kumari,Independent,3174,2,3176,1.79,150
15,16,Shiv Narayan Singh,Independent,4448,2,4450,2.51,150
16,17,Sanjay kumar,Independent,2349,0,2349,1.33,150
17,18,NOTA,None of the Above,2601,0,2601,1.47,150
0,1,Angad Kumar Kushwaha,Rashtriya Lok Samta Party,2751,10,2761,1.49,151
1,2,Aditya kumar shyour,Lok Jan Shakti Party,11526,50,11576,6.24,151
2,3,Doctor Sanjeev Kumar,Janata Dal (United),76916,310,77226,41.61,151
3,4,Digambar Prasad Tiwary,Rashtriya Janata Dal,75738,537,76275,41.1,151
4,5,Navin kumar,Jan Adhikar Party (Loktantrik),3286,12,3298,1.78,151
5,6,Ratna Priya,The Plurals Party,576,9,585,0.32,151
6,7,Sanjiv Kumar,Rashtriya Jan Vikas Party,590,5,595,0.32,151
7,8,Sahab Uddin,Rashtriya mahan Gantantra Party,313,0,313,0.17,151
8,9,Sikandar Sharma,"Log Jan Party - Secular,",478,6,484,0.26,151
9,10,Sudhir Yadav,Angika Samaj Party,501,1,502,0.27,151
10,11,Ishwar Sharan Shrivastava,Independent,938,3,941,0.51,151
11,12,Chandan Kumar ALIAS Sonu kumar,Independent,952,3,955,0.51,151
12,13,Priyadarshee Dinkar,Independent,3594,2,3596,1.94,151
13,14,Babulal Shrma,Independent,3392,1,3393,1.83,151
14,15,Mithlesh Kumar Das,Independent,1151,2,1153,0.62,151
15,16,NOTA,None of the Above,1916,7,1923,1.04,151
0,1,Kumar Shailendra,Bharatiya Janata Party,72577,361,72938,48.53,152
1,2,Shailesh Kumar,Rashtriya Janata Dal,66229,580,66809,44.45,152
2,3,Md. Haidar Ali,Bahujan Samaj Party,3529,24,3553,2.36,152
3,4,Ajmeri Khatun,Jan Adhikar Party (Loktantrik),531,0,531,0.35,152
4,5,Gautam Kumar Pritam,Socialist Party (India),1073,2,1075,0.72,152
5,6,Nidhi Bhushan,The Plurals Party,516,6,522,0.35,152
6,7,Mahendra Singh Parchadhari,Independent,779,2,781,0.52,152
7,8,Md. Sanovar,Independent,1361,3,1364,0.91,152
8,9,NOTA,None of the Above,2711,5,2716,1.81,152
0,1,Narendra Kumar Niraj,Janata Dal (United),75017,516,75533,46.39,153
1,2,Shailesh Kumar,Rashtriya Janata Dal,50437,635,51072,31.37,153
2,3,Sures Bhagat,Lok Jan Shakti Party,23247,159,23406,14.38,153
3,4,Premshankar Kumar,Vanchit Samaj Party,1370,7,1377,0.85,153
4,5,Shankar Kumar,Peoples Party of India (Democratic),779,4,783,0.48,153
5,6,Shabana Azmi,Jan Adhikar Party,1330,13,1343,0.82,153
6,7,Sanjeev Kumar Singh,Rashtriya Jan Jan Party,3969,33,4002,2.46,153
7,8,Ruchi Singh,Independent,1410,9,1419,0.87,153
8,9,NOTA,None of the Above,3879,9,3888,2.39,153
0,1,RAM VILASH PASWAN,Rashtriya Janata Dal,68817,393,69210,34.91,154
1,2,LALAN KUMAR,Bharatiya Janata Party,95811,418,96229,48.54,154
2,3,BISHNUDEV KUMAR PASWAN,Nationalist Congress Party,1910,7,1917,0.97,154
3,4,ANIL DAS,National Tiger Party,991,0,991,0.5,154
4,5,Upendra Paswan,Prabal Bharat Party,881,1,882,0.44,154
5,6,DILIP KUMAR,The Plurals Party,719,5,724,0.37,154
6,7,NARESH DAS,Rashtriya Jansambhavna Party,1303,1,1304,0.66,154
7,8,NIRMALA DEVI,Jharkhand Mukti Morcha,376,1,377,0.19,154
8,9,PANKAJ PASWAN,Peoples Party of India (Democratic),316,0,316,0.16,154
9,10,PRAVIN NAG,Bhartiya Dalit Party,308,2,310,0.16,154
10,11,RAVINDRA KUMAR DAS,Jan Adhikar Party (Loktantrik),450,0,450,0.23,154
11,12,RAJESH PASWAN,Bhartiya Sablog Party,494,3,497,0.25,154
12,13,SUDHIR KUMAR,Rashtriya Jan Jan Party,869,7,876,0.44,154
13,14,SUDHIR PASWAN,Bhartiya Party (Loktantrik),896,0,896,0.45,154
14,15,AJAY KUMAR PASWAN,Independent,2490,1,2491,1.26,154
15,16,AWADH KISHOR BHARTI,Independent,4029,1,4030,2.03,154
16,17,AMAN KUMAR,Independent,12668,52,12720,6.42,154
17,18,UDHALI PASWAN,Independent,1546,1,1547,0.78,154
18,19,DEO KUMAR PASWAN,Independent,361,1,362,0.18,154
19,20,PANKAJ PASWAN,Independent,563,0,563,0.28,154
20,21,SHANKAR RAVIDAS,Independent,563,1,564,0.28,154
21,22,NOTA,None of the Above,987,6,993,0.5,154
0,1,ANUJ KUMAR MANDAL,Nationalist Congress Party,2097,8,2105,1.02,155
1,2,KRISHNA KUMAR MANDAL,Bahujan Samaj Party,1346,4,1350,0.66,155
2,3,PAWAN KUMAR YADAV,Bharatiya Janata Party,115326,212,115538,56.23,155
3,4,SHUBHANAND MUKESH,Indian National Congress,72379,266,72645,35.36,155
4,5,ANIL YADAV,Jan Adhikar Party (Loktantrik),1272,3,1275,0.62,155
5,6,GULAM AHMAD,Bhartiya Sablog Party,641,2,643,0.31,155
6,7,PRATIMA DEVI,Bhartiya Party (Loktantrik),365,3,368,0.18,155
7,8,BHAGERATH KUMAR,Bharatiya Samta Samaj Party,717,1,718,0.35,155
8,9,MANOJ KUMAR YADAV,Vanchit Samaj Party,793,5,798,0.39,155
9,10,RAMCHANDRA MANDAL,Bharatiya Jan Kranti Dal (Democratic),725,0,725,0.35,155
10,11,BHOLA HARIJAN,Independent,854,5,859,0.42,155
11,12,MAHENDRA TANTI,Independent,1969,4,1973,0.96,155
12,13,BIJAY KUMAR YADAV,Independent,3101,6,3107,1.51,155
13,14,SADANAND SINGH,Independent,1166,1,1167,0.57,155
14,15,NOTA,None of the Above,2188,4,2192,1.07,155
0,1,AJIT SHARMA,Indian National Congress,65033,469,65502,40.52,156
1,2,MD. ASIF ALI,Nationalist Congress Party,495,3,498,0.31,156
2,3,RAJESH VERMA,Lok Jan Shakti Party,20434,89,20523,12.69,156
3,4,ROHIT PANDEY,Bharatiya Janata Party,64083,306,64389,39.83,156
4,5,SYED SHAH ALI SAJJAD ALAM,Rashtriya Lok Samta Party,2730,13,2743,1.7,156
5,6,AMIT ALOK,The Plurals Party,713,6,719,0.44,156
6,7,GAURAV TIWARI,Jai Maha Bharath Party,86,0,86,0.05,156
7,8,DAYARAM MANDAL,Prabal Bharat Party,212,1,213,0.13,156
8,9,NEELU DEVI,Bhartiya Dalit Party,152,0,152,0.09,156
9,10,PASUNN LALAINT,"Bhartiya Garibmazdoor Party,",142,0,142,0.09,156
10,11,RAVI KUMAR SINGH,SOCIALIST UNITY CENTRE OF INDIA (COMMUNIST),206,0,206,0.13,156
11,12,VINAY YADAV,Bharatiya Jan Kranti Dal (Democratic),273,0,273,0.17,156
12,13,SAHENDRA PRASAD SAHU,Bahujan Mukti Party,807,6,813,0.5,156
13,14,SUBODH MANDAL,National Tiger Party,680,0,680,0.42,156
14,15,BAJARANG BIHARI SHARMA,Independent,337,2,339,0.21,156
15,16,BIJAY PRASAD SAH,Independent,3280,12,3292,2.04,156
16,17,NOTA,None of the Above,1095,8,1103,0.68,156
0,1,Nilam Devi,Lok Jan Shakti Party,10176,46,10222,5.98,157
1,2,Lalan Kumar,Indian National Congress,61017,241,61258,35.82,157
2,3,Lalit Narayan Mandal,Janata Dal (United),72620,203,72823,42.58,157
3,4,Himanshu Prasad @ Himanshu Kumar,Rashtriya Lok Samta Party,5706,7,5713,3.34,157
4,5,Nand Kishor Sharma,Lok Samaj Party,722,6,728,0.43,157
5,6,Naresh Das,SOCIALIST UNITY CENTRE OF INDIA (COMMUNIST),1103,3,1106,0.65,157
6,7,Pankaj Kumar,Janta Dal Rashtravadi,777,1,778,0.45,157
7,8,Ravi Suman Kumar @ Arun Mandal,Bhartiya Sablog Party,4683,9,4692,2.74,157
8,9,Kiran Mishra,Independent,1294,9,1303,0.76,157
9,10,Madhu Priya,Independent,927,5,932,0.54,157
10,11,Raj Kumar,Independent,1509,5,1514,0.89,157
11,12,Rajan Kumar,Independent,2388,1,2389,1.4,157
12,13,Ramanand Paswan,Independent,2858,2,2860,1.67,157
13,14,NOTA,None of the Above,4710,9,4719,2.76,157
0,1,AMAR NATH PRASAD @ AMAR SINGH KUSHWAHA,Lok Jan Shakti Party,14673,42,14715,7.54,158
1,2,ALI ASHRAF SIDDIQUI,Rashtriya Janata Dal,78416,416,78832,40.41,158
2,3,ASHOK KUMAR,Bahujan Samaj Party,9621,38,9659,4.95,158
3,4,MOHAMMAD AKBAR ALI,Nationalist Congress Party,1083,4,1087,0.56,158
4,5,LAKSHMI KANT MANDAL,Janata Dal (United),70935,141,71076,36.44,158
5,6,AJAY KUMAR MANDAL,Bhartiya Party (Loktantrik),2314,5,2319,1.19,158
6,7,KUMARI ASHA,The Plurals Party,735,4,739,0.38,158
7,8,GAUTAM PANJIYARA,Rashtriya Manav Sewa Party,931,2,933,0.48,158
8,9,ZAFAR MUSTAFA,Jan Adhikar Party (Loktantrik),660,0,660,0.34,158
9,10,PAWAN KUMAR SAH,Bharatiya Jan Kranti Dal (Democratic),414,2,416,0.21,158
10,11,SHIV SHANKAR SHARMA,"Log Jan Party - Secular,",693,2,695,0.36,158
11,12,ANUJ KUMAR,Independent,2077,1,2078,1.07,158
12,13,GOURI SHANKAR SINGH,Independent,2371,1,2372,1.22,158
13,14,NAROTTAM SRIVASTAVA,Independent,1526,1,1527,0.78,158
14,15,BRAHAMDEV PASWAN,Independent,2161,1,2162,1.11,158
15,16,BHUNESHWAR MANDAL,Independent,2299,0,2299,1.18,158
16,17,SHAILENDRA KUMAR,Independent,1181,2,1183,0.61,158
17,18,SANJAY KUMAR,Independent,1111,0,1111,0.57,158
18,19,NOTA,None of the Above,1192,9,1201,0.62,158
0,1,Anil Kumar Singh,Nationalist Congress Party,2079,17,2096,1.28,159
1,2,Jayant Raj,Janata Dal (United),53963,345,54308,33.13,159
2,3,Jitendra Singh,Indian National Congress,50721,473,51194,31.23,159
3,4,Mrinal Shekhar,Lok Jan Shakti Party,40071,237,40308,24.59,159
4,5,Ashok Kumar,Right to Recall Party,1716,4,1720,1.05,159
5,6,Pushkar Kumar,Bhartiya Sablog Party,1045,4,1049,0.64,159
6,7,Pradip Kumar Ranjan,Bhartiya Party (Loktantrik),1386,5,1391,0.85,159
7,8,Anjani Kumar,Independent,862,3,865,0.53,159
8,9,AJAY KUMAR SINGH,Independent,1326,5,1331,0.81,159
9,10,Krishana Mohan Thakur,Independent,2087,2,2089,1.27,159
10,11,Pravin Kumar Jha,Independent,2121,4,2125,1.3,159
11,12,Bipin Kishor Ray,Independent,1923,0,1923,1.17,159
12,13,NOTA,None of the Above,3527,7,3534,2.16,159
0,1,Ashok Das,Nationalist Congress Party,1550,0,1550,0.86,160
1,2,Dipak Kumar Paswan,Lok Jan Shakti Party,4081,0,4081,2.27,160
2,3,Bhudeo Choudhary,Rashtriya Janata Dal,78646,0,78646,43.74,160
3,4,Manish Kumar,Janata Dal (United),75959,0,75959,42.24,160
4,5,Shiv Shankar,Rashtriya Lok Samta Party,3147,0,3147,1.75,160
5,6,Amod Harijan,Bhartiya Dalit Party,845,0,845,0.47,160
6,7,Prof. Bilkshan Ravidas,Jan Adhikar Party (Loktantrik),2948,0,2948,1.64,160
7,8,Mritunjay Kumar Ray,Vanchit Samaj Party,1811,0,1811,1.01,160
8,9,Puja Devi,Independent,2252,0,2252,1.25,160
9,10,Ranjeet Sharma,Independent,3108,0,3108,1.73,160
10,11,Sadanand Tanti,Independent,2244,0,2244,1.25,160
11,12,NOTA,None of the Above,3231,0,3231,1.8,160
0,1,Kaushal Kumar Singh,Rashtriya Lok Samta Party,10946,50,10996,6.9,161
1,2,Javed Iqbal Ansari,Rashtriya Janata Dal,52317,617,52934,33.24,161
2,3,Ram Narayan Mandal,Bharatiya Janata Party,69410,352,69762,43.8,161
3,4,Umakant Yadav,Bhartiya Dalit Party,889,3,892,0.56,161
4,5,Kundan Kumar Ray,Bhartiya Party (Loktantrik),455,7,462,0.29,161
5,6,Prakash Thakur,Janata Party,563,1,564,0.35,161
6,7,Mohmmad Abrar Muslim,Azad Samaj Party,287,6,293,0.18,161
7,8,Rajesh Yadav,Aam Janta Party Rashtriya,298,0,298,0.19,161
8,9,Rahul Roushan,Rashtriya Manav Sewa Party,1573,6,1579,0.99,161
9,10,Roshan Kumar Singh,Bhartiya Sablog Party,453,3,456,0.29,161
10,11,Kashinath Singh,Independent,662,5,667,0.42,161
11,12,Chandra Prakash,Independent,1776,16,1792,1.13,161
12,13,Naresh Kumar Priyadarshi,Independent,2728,20,2748,1.73,161
13,14,Pawan Kumar Thakur,Independent,2072,0,2072,1.3,161
14,15,Patric Murmu,Independent,2039,3,2042,1.28,161
15,16,Pramod Singh Weldone,Independent,2154,1,2155,1.35,161
16,17,"Manoj Singh, S/0-Janardan Singh",Independent,2037,3,2040,1.28,161
17,18,"Manoj Singh, S/0-Tekan Singh",Independent,1327,1,1328,0.83,161
18,19,Shridhar Mandal,Independent,5094,13,5107,3.21,161
19,20,NOTA,None of the Above,1075,9,1084,0.68,161
0,1,Dr. Nikki Hembrom,Bharatiya Janata Party,74544,241,74785,47.01,162
1,2,Sweety Sima Hembram,Rashtriya Janata Dal,67840,524,68364,42.98,162
2,3,Anjela Hansda,Jharkhand Mukti Morcha,5593,13,5606,3.52,162
3,4,Etwari Tudu,Apna Kisan Party,2097,4,2101,1.32,162
4,5,Roj Meri Kisku,Jan Adhikar Party (Loktantrik),2936,5,2941,1.85,162
5,6,NOTA,None of the Above,5276,3,5279,3.32,162
0,1,KUMARI ARCHANA,Lok Jan Shakti Party,5289,23,5312,2.9,163
1,2,BRAHMDEV RAY,Bahujan Samaj Party,6103,24,6127,3.34,163
2,3,MANOJ YADAV,Janata Dal (United),73284,305,73589,40.16,163
3,4,RAMDEO YADAV,Rashtriya Janata Dal,70571,545,71116,38.81,163
4,5,SHAILENDRA KUMAR SINGH,Rashtriya Lok Samta Party,3235,7,3242,1.77,163
5,6,AMRIT TANTI,Bhartiya Dalit Party,868,5,873,0.48,163
6,7,KABINDRA PANDIT,SOCIALIST UNITY CENTRE OF INDIA (COMMUNIST),1174,6,1180,0.64,163
7,8,KUMOD KUMAR,Rashtrawadi Janlok Party (Satya),679,0,679,0.37,163
8,9,NAND KISHORE PANDIT,Janata Party,1185,5,1190,0.65,163
9,10,BHOLA PD YADAV,Bhartiya Sablog Party,2272,5,2277,1.24,163
10,11,MUNESHWAR PRASAD YADAV,Prabal Bharat Party,1117,3,1120,0.61,163
11,12,VISHNU LAL MARANDI,Apna Kisan Party,1531,1,1532,0.84,163
12,13,Binod Pandit,Independent,5458,5,5463,2.98,163
13,14,SWATI KUMARI,Independent,4023,3,4026,2.2,163
14,15,HEMAN BESRA,Independent,2085,4,2089,1.14,163
15,16,NOTA,None of the Above,3428,2,3430,1.87,163
0,1,Jitendra Kumar,Rashtriya Lok Samta Party,5089,21,5110,2.93,164
1,2,Divya Prakash,Rashtriya Janata Dal,56943,300,57243,32.8,164
2,3,Mina Devi,Lok Jan Shakti Party,11203,61,11264,6.45,164
3,4,Mewa Lal Choudhary,Janata Dal (United),64199,269,64468,36.93,164
4,5,Anita Devi,Jantantrik Vikas Party,1997,2,1999,1.15,164
5,6,Arbind Kumar Singh,Bhartiya Sablog Party,1012,3,1015,0.58,164
6,7,Karmvir Kumar Bharti,Jan Adhikar Party (Loktantrik),1192,4,1196,0.69,164
7,8,Pramod Kumar Singh,Bhartiya Lok Chetna Party,1850,0,1850,1.06,164
8,9,Ranjit Ram,SOCIALIST UNITY CENTRE OF INDIA (COMMUNIST),913,2,915,0.52,164
9,10,Raj Kumar Das,Bahujan Mukti Party,1246,2,1248,0.71,164
10,11,Rinku Kumar,Rashtriya Manav Sewa Party,1068,3,1071,0.61,164
11,12,Sushant Kumar,Rashtriya Jan Jan Party,1531,3,1534,0.88,164
12,13,Om Prakash Rajak,Independent,1789,2,1791,1.03,164
13,14,Kanhaiya Lal Mishra,Independent,975,4,979,0.56,164
14,15,Jayram Singh,Independent,1633,5,1638,0.94,164
15,16,Deji Devi,Independent,1798,1,1799,1.03,164
16,17,Dharmvir Kumar Paswan,Independent,1380,4,1384,0.79,164
17,18,Balram Choudhary,Independent,1398,1,1399,0.8,164
18,19,Ravi Ranjan Kumar Suraj,Independent,1359,5,1364,0.78,164
19,20,Rajesh Kumar Mishra,Independent,10421,45,10466,6,164
20,21,Rajesh Kumar Singh,Independent,543,3,546,0.31,164
21,22,Rahul Kumar Sourav,Independent,621,2,623,0.36,164
22,23,Sanjay Kumar Singh,Independent,647,1,648,0.37,164
23,24,Sarvesh Kumar,Independent,665,2,667,0.38,164
24,25,Sunil Kumar Bind,Independent,796,0,796,0.46,164
25,26,NOTA,None of the Above,1527,7,1534,0.88,164
0,1,AVINASH KUMAR VIDYARTHI,Rashtriya Janata Dal,73748,581,74329,44.99,165
1,2,PRANAV KUMAR,Bharatiya Janata Party,75094,479,75573,45.74,165
2,3,MD MOKIM,Nationalist Congress Party,824,14,838,0.51,165
3,4,SUBODH VERMA,Rashtriya Lok Samta Party,1312,13,1325,0.8,165
4,5,JAMUNA LAL SRIVASTAVA,Bhartiya Rashtriya Dal,386,5,391,0.24,165
5,6,DEVANAND MANDAL,SOCIALIST UNITY CENTRE OF INDIA (COMMUNIST),254,5,259,0.16,165
6,7,MANOJ KUMAR PATEL,Bhartiya Sablog Party,605,5,610,0.37,165
7,8,MOHMMAD FAISAL AHMAD,Jan Adhikar Party (Loktantrik),246,3,249,0.15,165
8,9,SADDAM KHAN,Aam Jan Party (Secular),203,2,205,0.12,165
9,10,AWADHESH KUMAR YADAV,Independent,280,5,285,0.17,165
10,11,ADITYA SINGH MADHUKAR,Independent,374,0,374,0.23,165
11,12,KANCHAN KUMARI,Independent,1352,6,1358,0.82,165
12,13,ROHIT KUMAR,Independent,552,3,555,0.34,165
13,14,VIKAS KUMAR,Independent,1285,7,1292,0.78,165
14,15,SHALINI KUMARI,Independent,4478,19,4497,2.72,165
15,16,NOTA,None of the Above,3063,13,3076,1.86,165
0,1,AJAY KUMAR SINGH,Indian National Congress,56593,603,57196,37.65,166
1,2,INDRA DEO DAS,Nationalist Congress Party,1008,17,1025,0.67,166
2,3,DURGESH KUMAR SINGH,Lok Jan Shakti Party,14502,141,14643,9.64,166
3,4,SHAILESH KUMAR,Janata Dal (United),52125,639,52764,34.73,166
4,5,SUBODH TANTI,Bahujan Samaj Party,4367,16,4383,2.89,166
5,6,KAMESHWAR RAM,SOCIALIST UNITY CENTRE OF INDIA (COMMUNIST),1459,18,1477,0.97,166
6,7,PANCHANAND SINGH,Jantantrik Lokhit Party,607,6,613,0.4,166
7,8,MANGAL KUMAR,Janata Party,663,8,671,0.44,166
8,9,MAHESH YADAV,Jan Adhikar Party (Loktantrik),1823,17,1840,1.21,166
9,10,RINKU PASWAN,Bharatiya Jan Kranti Dal (Democratic),514,7,521,0.34,166
10,11,KAPILADEO MANDAL,Independent,653,8,661,0.44,166
11,12,GOPAL KUMAR TANTI,Independent,1151,3,1154,0.76,166
12,13,DOLLY KUMARI,Independent,2634,16,2650,1.74,166
13,14,DEEPAK KUMAR RAUT,Independent,1442,10,1452,0.96,166
14,15,DHIRENDRA KUMAR,Independent,1794,17,1811,1.19,166
15,16,PANKAJ KUMAR,Independent,3277,4,3281,2.16,166
16,17,PAPPU YADAV,Independent,1878,4,1882,1.24,166
17,18,PRIYA RAI,Independent,897,10,907,0.6,166
18,19,RAJ KUMAR RAY,Independent,902,5,907,0.6,166
19,20,NOTA,None of the Above,2054,18,2072,1.36,166
0,1,GANESH KUMAR,Rashtriya Lok Samta Party,3697,17,3714,1.96,167
1,2,PRAHLAD YADAV,Rashtriya Janata Dal,61635,671,62306,32.82,167
2,3,RAVISHANKER PRASAD SINGH,Lok Jan Shakti Party,44378,419,44797,23.6,167
3,4,RAMANAND MANDAL,Janata Dal (United),52308,409,52717,27.77,167
4,5,AKHILESHWAR BHAGAT,Bahujan Maha Party,796,4,800,0.42,167
5,6,AJAY KUMAR,Aam Janta Party Rashtriya,575,6,581,0.31,167
6,7,PAPPU SINGH,Rashtriya Jan Jan Party,1068,22,1090,0.57,167
7,8,RANA AMIT KUMAR SINGH,Janata Party,675,6,681,0.36,167
8,9,SHYAM KISHORE SINGH,Bhartiya Sablog Party,1632,7,1639,0.86,167
9,10,SANDIP KUMAR,Jantantrik Lokhit Party,958,2,960,0.51,167
10,11,ABHISHEK RANJAN,Independent,1155,7,1162,0.61,167
11,12,AMARJIT PATEL,Independent,986,4,990,0.52,167
12,13,GANGADHAR PANDEY,Independent,2951,3,2954,1.56,167
13,14,BIPIN KUMAR,Independent,4113,5,4118,2.17,167
14,15,MURARI SINGH,Independent,2134,3,2137,1.13,167
15,16,RANJAN KUMAR,Independent,2159,5,2164,1.14,167
16,17,RUPESH KUMAR SHRIVASTAVA,Independent,1336,1,1337,0.7,167
17,18,SHANKAR SHARMA ALIAS SHANKAR DAS JI MAHARAJ,Independent,1848,1,1849,0.97,167
18,19,SHARVAN KUMAR ANAND,Independent,1670,2,1672,0.88,167
19,20,NOTA,None of the Above,2134,13,2147,1.13,167
0,1,AMARESH KUMAR,Indian National Congress,63019,710,63729,32.8,168
1,2,RAJIV RANJAN KUMAR RAI,Bahujan Samaj Party,4057,28,4085,2.1,168
2,3,VIJAY KUMAR SINHA,Bharatiya Janata Party,73728,484,74212,38.2,168
3,4,VIJAY RAM,Aam Janta Party Rashtriya,1770,12,1782,0.92,168
4,5,VIMAL KUMAR,Jan Adhikar Party (Loktantrik),3084,11,3095,1.59,168
5,6,KUMARI BABITA,Independent,4898,24,4922,2.53,168
6,7,PRANAY KUMAR,Independent,585,4,589,0.3,168
7,8,FULENA SINGH,Independent,10850,88,10938,5.63,168
8,9,BHARATH MAHTO,Independent,685,7,692,0.36,168
9,10,MURARI KUMAR ALIAS MURARI KUMAR HARSH,Independent,941,3,944,0.49,168
10,11,RAKESH KUMAR,Independent,1071,8,1079,0.56,168
11,12,RAJENDRA PRASAD SAHU,Independent,2420,6,2426,1.25,168
12,13,VIJAY KUMAR,Independent,1252,7,1259,0.65,168
13,14,VIJAY PRASAD SINGH,Independent,3857,2,3859,1.99,168
14,15,SUJEET KUMAR S/O- BALMIKI SINGH,Independent,11496,74,11570,5.96,168
15,16,SUJIT KUMAR S/O- SUDHIR KUMAR SINGH,Independent,4014,7,4021,2.07,168
16,17,SUDHIR KUMAR,Independent,2321,10,2331,1.2,168
17,18,SUNIL KUMAR,Independent,691,7,698,0.36,168
18,19,NOTA,None of the Above,2039,19,2058,1.06,168
0,1,IMAM GHAZALI,Lok Jan Shakti Party,14486,66,14552,10.07,169
1,2,RANDHIR KUMAR SONI,Janata Dal (United),49864,385,50249,34.78,169
2,3,VIJAY KUMAR,Rashtriya Janata Dal,55867,498,56365,39.02,169
3,4,SANKET KUMAR,Rashtriya Lok Samta Party,3328,17,3345,2.32,169
4,5,AJAY KUMAR,Jan Adhikar Party (Loktantrik),959,12,971,0.67,169
5,6,DARO BIND,Jantantrik Lokhit Party,718,0,718,0.5,169
6,7,DILIP KUMAR,Rashtriya Jan Jan Party,4881,19,4900,3.39,169
7,8,KRISHNA MURARI KUMAR,Independent,768,1,769,0.53,169
8,9,GAUTAM KUMAR,Independent,1367,4,1371,0.95,169
9,10,RAJENDRA PRASAD GUPTA,Independent,2229,4,2233,1.55,169
10,11,RINKU DEVI,Independent,5996,16,6012,4.16,169
11,12,NOTA,None of the Above,2976,2,2978,2.06,169
0,1,GAJANAND SHAHI,Indian National Congress,39288,477,39765,33.09,170
1,2,NAVIN KUMAR,Nationalist Congress Party,822,12,834,0.69,170
2,3,MADHUKAR KUMAR,Lok Jan Shakti Party,18849,81,18930,15.75,170
3,4,MRITUNJAY KUMAR,Rashtriya Lok Samta Party,1756,7,1763,1.47,170
4,5,SUDARSHAN KUMAR,Janata Dal (United),39526,352,39878,33.19,170
5,6,GOPAL KUMAR,Rashtriya Jan Jan Party,4432,26,4458,3.71,170
6,7,DEEPAK KUMAR SHARMA,Independent,1767,3,1770,1.47,170
7,8,MOHAMAD AZAM KHAN,Independent,877,3,880,0.73,170
8,9,RAKESH RANJAN,Independent,7101,38,7139,5.94,170
9,10,RAJENDRA PRASAD,Independent,1107,3,1110,0.92,170
10,11,NOTA,None of the Above,3634,5,3639,3.03,170
0,1,ANIL KUMAR,Rashtriya Janata Dal,39595,330,39925,27.7,171
1,2,JITENDRA KUMAR,Janata Dal (United),51125,400,51525,35.75,171
2,3,RAMESH KUMAR,Lok Jan Shakti Party,21768,76,21844,15.16,171
3,4,ANIL KUMAR,Bharatiya Momin Front,1284,4,1288,0.89,171
4,5,GENORI MOCHI,Bahujan Mukti Party,935,3,938,0.65,171
5,6,DEOKI PASWAN,Bhartiya Rashtriya Dal,911,6,917,0.64,171
6,7,PUNAM KUMARI,The Plurals Party,1306,5,1311,0.91,171
7,8,RAGHUNATH RAM,Rashtriya Janwadi Party (Socialist),955,2,957,0.66,171
8,9,RAJEEV RANJAN,Bhartiya Sablog Party,666,1,667,0.46,171
9,10,VINITA KUMARI,Shiv Sena,405,2,407,0.28,171
10,11,SACHINDRA KUMAR,Bhartiya Party (Loktantrik),634,3,637,0.44,171
11,12,SUJAY KUMAR,Rashtriya Secular Majlis Party,560,2,562,0.39,171
12,13,SUSHIL PRASAD,Janata Dal  (Secular),1749,9,1758,1.22,171
13,14,AJEET KUMAR,Independent,2444,2,2446,1.7,171
14,15,UDAY SHANKAR KUMAR,Independent,2390,1,2391,1.66,171
15,16,GAURI KUMAR,Independent,3605,3,3608,2.5,171
16,17,CHANDRA MAULI PRASAD,Independent,1431,1,1432,0.99,171
17,18,BALMUKUND PASWAN,Independent,1257,2,1259,0.87,171
18,19,BIPIN KUMAR,Independent,9101,33,9134,6.34,171
19,20,NOTA,None of the Above,1098,4,1102,0.76,171
0,1,Rajkumar,Nationalist Congress Party,987,3,990,0.54,172
1,2,Shashikant Kumar Alias Banti Raj,Bahujan Samaj Party,1500,6,1506,0.82,172
2,3,Dr. Sunil Kumar Father's Name :-Bhagwat Prasad,Bharatiya Janata Party,81514,374,81888,44.55,172
3,4,Sunil Kumar Father’s Name :-  Shyamnandan Prasad,Rashtriya Janata Dal,66281,505,66786,36.34,172
4,5,Md. Akhtar,Loktantrik Janta Dal,1049,1,1050,0.57,172
5,6,Anish Kumar,Shoshit Samaj Dal,299,0,299,0.16,172
6,7,Ashok Kumar,Rashtriya Janshakti Party (Secular),304,2,306,0.17,172
7,8,Adarsh Patel,Jantantrik Vikas Party,832,1,833,0.45,172
8,9,Irshad Ahmad,All India Minorities Front,259,0,259,0.14,172
9,10,Prabhat Kumar Nirala,Sankhyanupati Bhagidari Party,436,0,436,0.24,172
10,11,Ravi Ranjan Kumar,Janata Party,474,1,475,0.26,172
11,12,Shamim Akhtar,SOCIAL DEMOCRATIC PARTY OF INDIA,2616,10,2626,1.43,172
12,13,Md. Safir Alam,Rashtriya Secular Majlis Party,1817,3,1820,0.99,172
13,14,Sudhanshu Kumar,Janata Dal  (Secular),1936,1,1937,1.05,172
14,15,Anil Kumar,Independent,1432,0,1432,0.78,172
15,16,Afreen Sultana,Independent,13422,21,13443,7.31,172
16,17,Umesh Paswan,Independent,570,0,570,0.31,172
17,18,Kaushal Kumar Kaushlendra Sinha Alias Bharat Manas,Independent,298,3,301,0.16,172
18,19,Manoj Prasad,Independent,1146,2,1148,0.62,172
19,20,Mithilesh Paswan,Independent,1005,0,1005,0.55,172
20,21,Ritu Kumar Alias Bhosu Bhai Yadav,Independent,2442,8,2450,1.33,172
21,22,Sachin Kumar,Independent,557,1,558,0.3,172
22,23,Sunil Paswan,Independent,520,3,523,0.28,172
23,24,NOTA,None of the Above,1145,7,1152,0.63,172
0,1,KAUSHAL KISHORE,Janata Dal (United),66837,354,67191,42.58,173
1,2,PAPPU PASWAN,Nationalist Congress Party,642,8,650,0.41,173
2,3,MANJU DEVI,Lok Jan Shakti Party,11130,44,11174,7.08,173
3,4,RAVI JOYTI KUMAR,Indian National Congress,50705,438,51143,32.41,173
4,5,SHAMBHU KUMAR,Bahujan Samaj Party,4945,9,4954,3.14,173
5,6,AMIT KUMAR PASWAN,Janata Dal  (Secular),1805,11,1816,1.15,173
6,7,AARTI DEVI,Shoshit Samaj Dal,579,4,583,0.37,173
7,8,KUMARI GUNJA SINHA,Jan Adhikar Party (Loktantrik),556,4,560,0.35,173
8,9,JAGDEO DAS,Jai Maha Bharath Party,819,6,825,0.52,173
9,10,MAHESH PASWAN,Bharat Bhrashtachar Mitao Party,475,4,479,0.3,173
10,11,RAKESH PASWAN,Bhartiya Rashtriya Dal,1171,1,1172,0.74,173
11,12,SANJAY KUMAR,Rashtriya Secular Majlis Party,1271,9,1280,0.81,173
12,13,SATISH MANJHI,Bhartiya Sablog Party,2723,2,2725,1.73,173
13,14,SURENDRA KUMAR ARYA,Maanavvaadi Janta Party,1326,3,1329,0.84,173
14,15,SONU KUMAR,Lok Jan Vikas Morcha,904,5,909,0.58,173
15,16,ASHOK KUMAR,Independent,3841,1,3842,2.43,173
16,17,UPENDRA PRASAD,Independent,2203,0,2203,1.4,173
17,18,VALRAM DAS,Independent,287,1,288,0.18,173
18,19,VILAS PASWAN,Independent,698,4,702,0.44,173
19,20,SATYENDRA KUMAR,Independent,1428,4,1432,0.91,173
20,21,SURESH KUMAR DAS,Independent,734,1,735,0.47,173
21,22,SURESH RAM,Independent,321,3,324,0.21,173
22,23,NOTA,None of the Above,1482,8,1490,0.94,173
0,1,Chandra Sen Prasad,Janata Dal (United),64052,338,64390,39.39,174
1,2,Naresh Prasad Singh,Lok Jan Shakti Party,8570,27,8597,5.26,174
2,3,Bharat Prasad Singh,Rashtriya Lok Samta Party,3706,13,3719,2.27,174
3,4,Rakesh Kumar Roushan,Rashtriya Janata Dal,67819,269,68088,41.65,174
4,5,Siyasharan Prasad Singh,Nationalist Congress Party,978,6,984,0.6,174
5,6,Ajit Kumar,Rashtriya Janwadi Party (Socialist),461,0,461,0.28,174
6,7,Kumar Pankaj Prasad,Bharatiya Inqalab Party,244,0,244,0.15,174
7,8,Dayanand Prasad,The Plurals Party,594,2,596,0.36,174
8,9,Pankaj Kumar,Bharat Bhrashtachar Mitao Party,318,2,320,0.2,174
9,10,Madan Kumar,Pragatisheel Magahi Samaj,396,2,398,0.24,174
10,11,Munna Kumar Keshari,Janata Dal  (Secular),678,4,682,0.42,174
11,12,Vikash Kumar Gaurav,National Jagaran Party,823,4,827,0.51,174
12,13,Shatrudhan Prasad Malakar,Sanyukt Kisan Vikas Party,3289,3,3292,2.01,174
13,14,Ajay Kumar,Independent,843,0,843,0.52,174
14,15,Mahendra Singh Yadav,Independent,3742,8,3750,2.29,174
15,16,Meena Devi,Independent,3359,0,3359,2.05,174
16,17,Sameer Kumar,Independent,1883,1,1884,1.15,174
17,18,NOTA,None of the Above,1039,5,1044,0.64,174
0,1,Atri Muni urf Shakti Singh Yadav,Rashtriya Janata Dal,61603,233,61836,37.35,175
1,2,Kumar Suman Singh urf Ranjit Singh,Lok Jan Shakti Party,17435,36,17471,10.55,175
2,3,Krishnamurari Sharan urf Prem Mukhiya,Janata Dal (United),61616,232,61848,37.35,175
3,4,Jainendra Kumar,Nationalist Congress Party,968,4,972,0.59,175
4,5,Ramvilaf Paswan,Bahujan Samaj Party,3077,5,3082,1.86,175
5,6,Abhay Shankar,Rashtriya Jan Jan Party,2109,13,2122,1.28,175
6,7,Kumar Haricharan Singh Yadav,Bharatiya Momin Front,255,0,255,0.15,175
7,8,Niraj Sharma,Janata Dal  (Secular),418,3,421,0.25,175
8,9,Mamta Rani urf Pinki Devi,Prabal Bharat Party,474,3,477,0.29,175
9,10,Ravindar Das,Shoshit Samaj Dal,691,1,692,0.42,175
10,11,Rajiv Nayan Prasad,The Plurals Party,652,7,659,0.4,175
11,12,Raju Kumar,Jan Adhikar Party (Loktantrik),2668,4,2672,1.61,175
12,13,Shyam Kant Kumar,National Jagaran Party,682,0,682,0.41,175
13,14,Suryamani Prakash,Jantantrik Vikas Party,1949,0,1949,1.18,175
14,15,Ashok Kumar,Independent,969,0,969,0.59,175
15,16,Kapil Prasad,Independent,2791,0,2791,1.69,175
16,17,Dular Chand Prasad,Independent,2841,2,2843,1.72,175
17,18,Munendra Kumar,Independent,1024,1,1025,0.62,175
18,19,Sudhir Kumar,Independent,1791,1,1792,1.08,175
19,20,NOTA,None of the Above,1016,6,1022,0.62,175
0,1,Gunjan Patel,Indian National Congress,17156,137,17293,10.2,176
1,2,Ram Keshwar Prasad,Lok Jan Shakti Party,10913,38,10951,6.46,176
2,3,Shrawon Kumar,Janata Dal (United),65646,420,66066,38.97,176
3,4,Sonu Kumar,Rashtriya Lok Samta Party,5313,31,5344,3.15,176
4,5,Ajay Kumar,Jan Adhikar Party (Loktantrik),812,2,814,0.48,176
5,6,Ashok Kumar,Lok Jan Vikas Morcha,551,4,555,0.33,176
6,7,Indrajeet Paswan,Peoples Party of India (Democratic),1047,23,1070,0.63,176
7,8,Kaushlendra Kumar,Jantantrik Vikas Party,49768,221,49989,29.48,176
8,9,Mani Kumar Singh,Bahujan Lok Dal,2188,3,2191,1.29,176
9,10,Raj Kumar Singh,Bharat Bhrashtachar Mitao Party,774,1,775,0.46,176
10,11,Rajiv Kumar,Yuva Bihar Sena,884,2,886,0.52,176
11,12,Brahamdev Prasad,Shoshit Samaj Dal,1026,4,1030,0.61,176
12,13,Sanjiv Ranjan Kumar Singh,Rashtrawadi Janlok Party (Satya),1401,4,1405,0.83,176
13,14,Sanyukta Kumari,Maanavvaadi Janta Party,1881,3,1884,1.11,176
14,15,MD Asgar Bharti,Independent,1282,1,1283,0.76,176
15,16,Kumar Rajesh,Independent,2506,0,2506,1.48,176
16,17,Dev Kumar,Independent,870,0,870,0.51,176
17,18,Vandna Sinha,Independent,646,3,649,0.38,176
18,19,Rahul Raushan,Independent,1971,5,1976,1.17,176
19,20,Suvant Vikram Rao,Independent,697,2,699,0.41,176
20,21,NOTA,None of the Above,1308,8,1316,0.78,176
0,1,KUNDAN KUMAR,Indian National Congress,21003,141,21144,13.33,177
1,2,KAUSHLENDRA KUMAR SINGH,Bahujan Samaj Party,6825,21,6846,4.32,177
2,3,MAMTA DEVI,Lok Jan Shakti Party,37951,212,38163,24.06,177
3,4,HARI NARAYAN SINGH,Janata Dal (United),65001,403,65404,41.24,177
4,5,ALOK KUMAR,Satya Bahumat Party,1011,3,1014,0.64,177
5,6,ASHUTOSH KUMAR SINHA,"Proutist Bloc, India",1838,6,1844,1.16,177
6,7,KANHAIYA LAL YADAV,Swaraj Party (Loktantrik),485,3,488,0.31,177
7,8,KARUNA KUMARI,Rashtriya Jan Jan Party,2237,13,2250,1.42,177
8,9,GANESH KUMAR,Samata Party,768,3,771,0.49,177
9,10,CHANDRA UDAY KUMAR,The Plurals Party,771,5,776,0.49,177
10,11,PRIYANKA KUMARI,Shoshit Samaj Dal,890,5,895,0.56,177
11,12,BAHUMULYA KUMAR SINGH,Prabal Bharat Party,1328,6,1334,0.84,177
12,13,REKHA KUMARI,Purvanchal Mahapanchayat,1776,4,1780,1.12,177
13,14,VIJAY KUMAR,Pragatisheel Magahi Samaj,1796,4,1800,1.13,177
14,15,SHASHI RANJAN SUMAN,Aam Janta Party Rashtriya,1070,5,1075,0.68,177
15,16,SANJAY SINGH,Jan Adhikar Party (Loktantrik),2419,1,2420,1.53,177
16,17,ASHOK KUMAR SINGH,Independent,2971,9,2980,1.88,177
17,18,ALOK KUMAR,Independent,788,0,788,0.5,177
18,19,JAGATNARAYAN,Independent,1526,2,1528,0.96,177
19,20,DHARMENDRA KUMAR,Independent,1234,1,1235,0.78,177
20,21,PINTU KUMAR,Independent,420,2,422,0.27,177
21,22,MUKESH KUMAR,Independent,1604,3,1607,1.01,177
22,23,LALLU RAM,Independent,412,4,416,0.26,177
23,24,SHIV NARAYAN,Independent,329,0,329,0.21,177
24,25,NOTA,None of the Above,1289,10,1299,0.82,177
0,1,Anant Kumar Singh,Rashtriya Janata Dal,78383,338,78721,52.99,178
1,2,Dilraj Raushan,Rashtriya Lok Samta Party,3993,14,4007,2.7,178
2,3,Rajeev Lochan Narayan Singh,Janata Dal (United),42749,215,42964,28.92,178
3,4,Suresh Singh Nishad,Lok Jan Shakti Party,13299,32,13331,8.97,178
4,5,Ashok Kumar,Jagrook Janta Party,827,4,831,0.56,178
5,6,Doctor Vinay Kumar,Independent,1096,5,1101,0.74,178
6,7,Dr. Dharambir Kumar,Independent,1722,1,1723,1.16,178
7,8,Ramesh Prasad,Independent,1341,2,1343,0.9,178
8,9,NOTA,None of the Above,4520,14,4534,3.05,178
0,1,GYANENDRA KUMAR SINGH,Bharatiya Janata Party,49077,250,49327,32.94,179
1,2,RAKESH KUMAR,Rashtriya Lok Samta Party,1033,4,1037,0.69,179
2,3,SATYENDRA BAHADUR,Indian National Congress,38993,94,39087,26.1,179
3,4,KRISHNA KUMAR SINGH,Akhil Bhartiya Manavadhikar Vichar Manch Party,826,0,826,0.55,179
4,5,DINA SAW,Bhartiya Rashtriya Dal,450,7,457,0.31,179
5,6,MOHAN PRASAD SINGH,Jan Sangharsh Virat Party,479,2,481,0.32,179
6,7,RAHUL RAJ,Bhartiya Sablog Party,1778,0,1778,1.19,179
7,8,SHYAM DEO PRASAD SINGH,Jan Adhikar Party (Loktantrik),1435,2,1437,0.96,179
8,9,SIYARAM PANDIT,Bharatiya Jan Kranti Dal (Democratic),1075,1,1076,0.72,179
9,10,KARN VEER SINGH YADAV,Independent,38369,37,38406,25.65,179
10,11,PRATIMA SINHA,Independent,779,0,779,0.52,179
11,12,BALMIKI PRASAD,Independent,500,0,500,0.33,179
12,13,MADHUKAR JAY VIJAY,Independent,907,1,908,0.61,179
13,14,"RANVEER KUMAR ""PANKAJ""",Independent,5946,13,5959,3.98,179
14,15,RAJ KUMARI,Independent,1388,5,1393,0.93,179
15,16,RANA SUDHIR KUMAR SINGH,Independent,3326,2,3328,2.22,179
16,17,VINAY SINGH,Independent,1149,2,1151,0.77,179
17,18,SUBODH KUMAR,Independent,348,0,348,0.23,179
18,19,NOTA,None of the Above,1447,14,1461,0.98,179
0,1,ANIRUDDH KUMAR,Rashtriya Janata Dal,89241,242,89483,52.17,180
1,2,RANVIJAY SINGH,Bharatiya Janata Party,68547,264,68811,40.12,180
2,3,VINOD YADAV,Rashtriya Lok Samta Party,1889,4,1893,1.1,180
3,4,AVANTIKA SINGH,Bharatiya Jan Kranti Dal (Democratic),362,1,363,0.21,180
4,5,UMESH PANDIT,Jawan Kisan Morcha,463,1,464,0.27,180
5,6,KUNDAN KUMAR,The Plurals Party,632,7,639,0.37,180
6,7,NARESH KUMAR,Asli Deshi Party,325,1,326,0.19,180
7,8,PURUSOTAM KUMAR,Jan Adhikar Party (Loktantrik),481,0,481,0.28,180
8,9,RANDHIR KUMAR,Swaraj Party (Loktantrik),277,2,279,0.16,180
9,10,RAJU KUMAR SINGH,Rashtrawadi Janlok Party (Satya),1117,2,1119,0.65,180
10,11,KRISHNA PRASAD,Independent,411,1,412,0.24,180
11,12,RAMJATAN CHOUDHARY,Independent,587,1,588,0.34,180
12,13,SHAMBHU SINGH,Independent,1033,2,1035,0.6,180
13,14,SITA DEVI,Independent,1875,3,1878,1.09,180
14,15,NOTA,None of the Above,3738,6,3744,2.18,180
0,1,JAY PRAKASH RAY,Nationalist Congress Party,989,0,989,0.58,181
1,2,SANJAY KUMAR SINHA,Rashtriya Lok Samta Party,5570,0,5570,3.28,181
2,3,SANJIV CHAURASIA,Bharatiya Janata Party,97044,0,97044,57.09,181
3,4,ANIL KUMAR PASWAN,"Log Jan Party - Secular,",1132,0,1132,0.67,181
4,5,ANIL KUMAR SHRIVASTAVA,Loktantrik Janshakti Party,893,0,893,0.53,181
5,6,OM PRAKASH,Apna Kisan Party,445,0,445,0.26,181
6,7,CHOTE LAL RAY,Rashtriya Jansambhavna Party,431,0,431,0.25,181
7,8,DINA NATH PASWAN,Swabhiman Party,543,0,543,0.32,181
8,9,MAYA SHRIVASTAVA,Bhartiya Sablog Party,602,0,602,0.35,181
9,10,RAJANI KUMARI,Asli Deshi Party,480,0,480,0.28,181
10,11,LEENA PRIYA,Rashtriya Sahyog Party,615,0,615,0.36,181
11,12,VIKAS CHANDRA,Bhartiya Party (Loktantrik),852,0,852,0.5,181
12,13,SHAMBHAVI,The Plurals Party,4701,0,4701,2.77,181
13,14,SHASHI YADAV,Communist Party of India  (Marxist-Leninist)  (Liberation),50971,0,50971,29.98,181
14,15,SANJAY YADAV,National Jagaran Party,598,0,598,0.35,181
15,16,MANOJ KUMAR,Independent,1215,0,1215,0.71,181
16,17,VARUNI POORVA,Independent,410,0,410,0.24,181
17,18,SUBHAM KUMAR,Independent,389,0,389,0.23,181
18,19,NOTA,None of the Above,2113,0,2113,1.24,181
0,1,NITIN NABIN,Bharatiya Janata Party,82873,195,83068,59.05,182
1,2,LUV SINHA,Indian National Congress,43908,124,44032,31.3,182
2,3,SUSHIL KUMAR SINGH,Nationalist Congress Party,442,0,442,0.31,182
3,4,ARVIND KUMAR SINGH,Public Mission Party,520,0,520,0.37,182
4,5,INDRA KUMAR SINGH CHANDAPURI,Jan Adhikar Party (Loktantrik),584,0,584,0.42,182
5,6,TEJASWANI JYOTI,Bhartiya Lok Chetna Party,461,2,463,0.33,182
6,7,DUKHAN PASWAN,Rashtriya Jansambhavna Party,199,0,199,0.14,182
7,8,NITESH KUMAR,Janta Dal Rashtravadi,354,0,354,0.25,182
8,9,PIYUSH KANT SINGH,Bahujan Nyay Dal,139,0,139,0.1,182
9,10,PUSHPAM PRIYA,The Plurals Party,5176,13,5189,3.69,182
10,11,VIKASH KUMAR ROY,Bharatiya Momin Front,242,1,243,0.17,182
11,12,SANJEEV KUMAR,Bhartiya Party (Loktantrik),316,0,316,0.22,182
12,13,SUBODH KUMAR,Shoshit Samaj Dal,531,0,531,0.38,182
13,14,SAURABH SINGH,Bhartiya Sablog Party,727,0,727,0.52,182
14,15,ANANG BHUSHAN VERMA @BABLOO,Independent,468,0,468,0.33,182
15,16,USHA DEVI SRIVASTAVA,Independent,727,0,727,0.52,182
16,17,KAUSHAL KISHORE PANDEY,Independent,487,0,487,0.35,182
17,18,JAYA LAXMI,Independent,324,1,325,0.23,182
18,19,PAVAN KUMAR JHA,Independent,118,0,118,0.08,182
19,20,PRABHASH CHANDRA SHARMA,Independent,127,0,127,0.09,182
20,21,MANISH BARRIARR,Independent,207,0,207,0.15,182
21,22,MUKND KUMAR,Independent,204,0,204,0.15,182
22,23,NOTA,None of the Above,1207,6,1213,0.86,182
0,1,Arun Kumar Sinha,Bharatiya Janata Party,81250,150,81400,54,183
1,2,Dharamendra Kumar,Rashtriya Janata Dal,54784,153,54937,36.44,183
2,3,Prabhunath Kumar Azad,Bahujan Samaj Party,688,2,690,0.46,183
3,4,Sumit Ranjan Sinha,Nationalist Congress Party,157,1,158,0.1,183
4,5,Anita Devi,Ambedkar National Congress,152,1,153,0.1,183
5,6,Arun Kumar Mehta,Apna Kisan Party,184,0,184,0.12,183
6,7,Ashok Kumar Keshri,Rashtra Sewa Dal,99,0,99,0.07,183
7,8,Uttam Kumar,Janta Dal Rashtravadi,254,0,254,0.17,183
8,9,Kumar Raunak,The Plurals Party,1244,4,1248,0.83,183
9,10,Krishna Nandan Saw,Sarv Jan Party (Bharat),193,0,193,0.13,183
10,11,Tapendra Narayan,Jantantrik Lokhit Party,327,0,327,0.22,183
11,12,Purushottam Kumar,Bharatiya Jan Kranti Dal (Democratic),162,0,162,0.11,183
12,13,Prem Shanker Prasad,"Proutist Bloc, India",225,0,225,0.15,183
13,14,Fazal Ahmad,Janata Dal  (Secular),314,0,314,0.21,183
14,15,Brajeshwar Prasad Singh,Sanyukt Kisan Vikas Party,525,0,525,0.35,183
15,16,"Rajesh Ranjan ""Pappu""",Jan Adhikar Party (Loktantrik),4324,9,4333,2.87,183
16,17,Vikash Kumar,Jan Sangharsh Virat Party,566,0,566,0.38,183
17,18,Sharad,Bhartiya Sablog Party,777,2,779,0.52,183
18,19,Suryakar Jitendra,SOCIALIST UNITY CENTRE OF INDIA (COMMUNIST),194,0,194,0.13,183
19,20,Amit Kumar,Independent,334,0,334,0.22,183
20,21,Khurshid Alam,Independent,73,0,73,0.05,183
21,22,Binod Kumar Pathak,Independent,1255,5,1260,0.84,183
22,23,Madhumesh Choudhary,Independent,489,0,489,0.32,183
23,24,Shatrudhan Prasad,Independent,289,0,289,0.19,183
24,25,NOTA,None of the Above,1553,5,1558,1.03,183
0,1,JAGDEEP PRASAD VERMA,Rashtriya Lok Samta Party,1190,2,1192,0.63,184
1,2,NAND KISHORE  YADAV,Bharatiya Janata Party,97582,110,97692,51.91,184
2,3,PRAVIN SINGH,Indian National Congress,79301,91,79392,42.19,184
3,4,CHANDRA SHEKHAR DAS,Bahujan Mukti Party,802,2,804,0.43,184
4,5,MD. MAHAMUD KURAISHI,Jan Adhikar Party (Loktantrik),979,5,984,0.52,184
5,6,YOGESH KUMAR SHUKLA,Bhartiya Sablog Party,284,0,284,0.15,184
6,7,VIKASH KUMAR CHOUDHARY,Aapki Apni Adhikar Party,253,0,253,0.13,184
7,8,Shiva Nandan  Tiwari,Prabal Bharat Party,464,0,464,0.25,184
8,9,AMIT KUMAR ALBELA,Independent,447,0,447,0.24,184
9,10,DAYA SINGH,Independent,1031,0,1031,0.55,184
10,11,MITHILESH KUMAR ROY,Independent,1264,0,1264,0.67,184
11,12,RAM NATH MAHTO,Independent,1147,1,1148,0.61,184
12,13,NOTA,None of the Above,3230,4,3234,1.72,184
0,1,Dr. Ramanand Yadav,Rashtriya Janata Dal,85634,135,85769,50.87,185
1,2,SATYENDRA KUMAR SINGH,Bharatiya Janata Party,66227,172,66399,39.38,185
2,3,SUNIL KUMAR,Bahujan Samaj Party,1415,2,1417,0.84,185
3,4,Ajeet Kumar Singh,The Plurals Party,607,3,610,0.36,185
4,5,Gajendra Kumar Father- Suryakant Prasad Sinha,Sankhyanupati Bhagidari Party,211,1,212,0.13,185
5,6,DEENANATH PASWAN,Peoples Party of India (Democratic),253,0,253,0.15,185
6,7,DHARMENDRA SINGH,Bharatiya Momin Front,197,0,197,0.12,185
7,8,RAJKISHORE PRASAD,Bahujan Mukti Party,326,0,326,0.19,185
8,9,Vinay Kumar,Bhartiya Panchyat Party,232,0,232,0.14,185
9,10,VINAY SINGH,Sanyukt Kisan Vikas Party,275,0,275,0.16,185
10,11,Shyam Karan Mistry,Swabhiman Party,545,2,547,0.32,185
11,12,Sachchidanand Singh,Jan Adhikar Party,1077,0,1077,0.64,185
12,13,Ajit Kumar,Independent,411,0,411,0.24,185
13,14,Gajendra Kumar Father- Ganesh Ray,Independent,618,0,618,0.37,185
14,15,DHIRENDRA KUMAR,Independent,1572,0,1572,0.93,185
15,16,Rakesh Sharma,Independent,2819,0,2819,1.67,185
16,17,Shakti Paswan,Independent,2374,0,2374,1.41,185
17,18,SANJEET KUMAR,Independent,1308,2,1310,0.78,185
18,19,SUDHIR KUMAR YADAV,Independent,1417,3,1420,0.84,185
19,20,NOTA,None of the Above,757,5,762,0.45,185
0,1,Asha Devi,Bharatiya Janata Party,73720,251,73971,39.86,186
1,2,Deepak Kumar,Rashtriya Lok Samta Party,7716,15,7731,4.17,186
2,3,Manoj Kumar Sinha,Nationalist Congress Party,633,4,637,0.34,186
3,4,Rit lal Ray,Rashtriya Janata Dal,89725,170,89895,48.44,186
4,5,Amar Nath Ray,The Plurals Party,1444,5,1449,0.78,186
5,6,AMRENDRA KUMAR ANAND,Loktantrik Sarvjan Samaj Party,457,2,459,0.25,186
6,7,RAGHUVIR MAHTO,Rashtriya Jansambhavna Party,382,1,383,0.21,186
7,8,Rakesh Kumar Ranjan,Jawan Kisan Morcha,428,1,429,0.23,186
8,9,Vijay Shanker Mishra,Bharatiya Jan Kranti Dal (Democratic),303,1,304,0.16,186
9,10,Shambhu Sharma,"Log Jan Party - Secular,",374,1,375,0.2,186
10,11,DR. SIDHESHWAR PRASAD,Bhartiya Rashtriya Dal,440,0,440,0.24,186
11,12,SURAJ DEV RAY,Bhartiya Lokmat Rashtrwadi Party,634,0,634,0.34,186
12,13,Ganesh Ray,Independent,2265,0,2265,1.22,186
13,14,RAMESH KUMAR,Independent,500,1,501,0.27,186
14,15,Ramji Ray,Independent,456,1,457,0.25,186
15,16,Shyam Rajak,Independent,1420,2,1422,0.77,186
16,17,SURAJ Prasad,Independent,866,0,866,0.47,186
17,18,Surendra Prasad,Independent,756,0,756,0.41,186
18,19,Sonu Kumar,Independent,273,1,274,0.15,186
19,20,NOTA,None of the Above,2302,13,2315,1.25,186
0,1,NIKHIL ANAND,Bharatiya Janata Party,61151,155,61306,30.86,187
1,2,BHAI VIRENDRA,Rashtriya Janata Dal,94070,153,94223,47.44,187
2,3,AJAY KUMAR SINGH,Republican Party of India (Rashtriya),1350,0,1350,0.68,187
3,4,KRISHNA BHAGWAN SINGH,Samajwadi Janata Dal Democratic,889,1,890,0.45,187
4,5,CHAUDHARY BRAHM PRAKASH SINGH,Jan Adhikar Party (Loktantrik),847,1,848,0.43,187
5,6,DEVANAND YADAV,Janata Party,857,1,858,0.43,187
6,7,RANJANA SINGH,Peoples Party of India (Democratic),377,3,380,0.19,187
7,8,RABINDRA KUMAR,Shiv Sena,391,0,391,0.2,187
8,9,RAM SWARUP CHAUHAN,Rashtriya Jansambhavna Party,493,0,493,0.25,187
9,10,SHIV KUMAR SINGH,Bharatiya Momin Front,401,0,401,0.2,187
10,11,SHOBHA DEVI,Bhartiya Manavta Party,482,1,483,0.24,187
11,12,SATISH KUMAR,Jai Maha Bharath Party,694,0,694,0.35,187
12,13,KAMESHWAR KUMAR,Independent,3107,1,3108,1.56,187
13,14,KUSH KUMAR,Independent,3025,9,3034,1.53,187
14,15,JANME JAY KUMAR,Independent,2786,0,2786,1.4,187
15,16,JAVAHAR SINGH,Independent,2862,1,2863,1.44,187
16,17,BASANT RAW SATHE,Independent,2015,3,2018,1.02,187
17,18,RANDHIR KUMAR SHARMA,Independent,1718,0,1718,0.86,187
18,19,RAJ KISHOR SINGH,Independent,560,0,560,0.28,187
19,20,VIKASH KUMAR,Independent,4020,4,4024,2.03,187
20,21,SHRIKANT NIRALA,Independent,14597,18,14615,7.36,187
21,22,SANNU DEVI,Independent,479,0,479,0.24,187
22,23,NOTA,None of the Above,1103,3,1106,0.56,187
0,1,ARUN MANJHI,Janata Dal (United),77104,163,77267,36.95,188
1,2,SURENDRA PASWAN,Nationalist Congress Party,1570,15,1585,0.76,188
2,3,AMARENDRA KUMAR,Sanyukt Kisan Vikas Party,2104,8,2112,1.01,188
3,4,KAMLESH KANT CHAUDHARY,Bhartiya Lok Chetna Party,3880,5,3885,1.86,188
4,5,KUMAR JAINENDRA PRASAD,Bahujan Nyay Dal,1080,1,1081,0.52,188
5,6,KUMARI PRATIBHA,All India Majlis-E-Ittehadul Muslimeen,5015,4,5019,2.4,188
6,7,KAILASH PASWAN,Rashtriya Jagriti Party,968,0,968,0.46,188
7,8,GAJENDRA MANJHI,Bhartiya Sablog Party,3479,1,3480,1.66,188
8,9,GOPAL RAVIDAS,Communist Party of India  (Marxist-Leninist)  (Liberation),90974,150,91124,43.57,188
9,10,DHURI DAS,Peoples Party of India (Democratic),1100,4,1104,0.53,188
10,11,BACHCHU PASWAN,Bahujan Mukti Party,943,6,949,0.45,188
11,12,MOTI RAM,Ambedkar National Congress,908,1,909,0.43,188
12,13,RAVI KUMAR,The Plurals Party,1675,4,1679,0.8,188
13,14,RADHE RAMAN,Bhartiya Dalit Party,658,3,661,0.32,188
14,15,RAMESHWAR PASWAN,Rashtriya Jansambhavna Party,949,1,950,0.45,188
15,16,SHILA DEVI,Loktantrik Samajwadi Party,2281,2,2283,1.09,188
16,17,SHRIRAJ PASWAN,Prabal Bharat Party,1733,0,1733,0.83,188
17,18,SATYAM KUMAR  RAJAK,Bharatiya Aam Awam Party,531,1,532,0.25,188
18,19,SATYENDRA PASWAN,Jan Adhikar Party (Loktantrik),1764,3,1767,0.84,188
19,20,AMAR PASWAN,Independent,506,0,506,0.24,188
20,21,ARJUN PASWAN,Independent,381,0,381,0.18,188
21,22,PRATIMA KUMARI (Sanjay Paswan),Independent,727,3,730,0.35,188
22,23,PRATIMA KUMARI (Santosh Kumar),Independent,1143,1,1144,0.55,188
23,24,MANOHAR PRAKASH CHAUDHARY,Independent,866,0,866,0.41,188
24,25,LAXMI KUMARI,Independent,2163,0,2163,1.03,188
25,26,SHANKAR KUMAR,Independent,997,1,998,0.48,188
26,27,NOTA,None of the Above,3229,16,3245,1.55,188
0,1,JITENDRA KUMAR,Nationalist Congress Party,1341,6,1347,0.69,189
1,2,NUTAN PASWAN,Janata Dal (United),66337,132,66469,33.81,189
2,3,PARSHURAM KUMAR,Lok Jan Shakti Party,9669,13,9682,4.93,189
3,4,RAJ KUMAR RAM,Bahujan Samaj Party,5406,6,5412,2.75,189
4,5,REKHA DEVI,Rashtriya Janata Dal,98498,198,98696,50.21,189
5,6,ANIL DAS,Bhartiya Dalit Party,1281,0,1281,0.65,189
6,7,NARESH MANJHI,Bahujan Mukti Party,576,0,576,0.29,189
7,8,RAMASHISH PASWAN,Loktantrik Samajwadi Party,560,0,560,0.28,189
8,9,VIMAL CHANDRA DAS,Peoples Party of India (Democratic),803,3,806,0.41,189
9,10,SARITA PASWAN,Bhartiya Sablog Party,3014,2,3016,1.53,189
10,11,ANIL KUMAR,Independent,1098,2,1100,0.56,189
11,12,RAMJI RAVIDAS,Independent,1857,0,1857,0.94,189
12,13,SIKANDAR PASWAN,Independent,2184,1,2185,1.11,189
13,14,NOTA,None of the Above,3574,9,3583,1.82,189
0,1,Dr. USHA VIDYARTHI,Lok Jan Shakti Party,16024,78,16102,10.37,190
1,2,JAY VARDHAN YADAV @ BACHCHA YADAV,Janata Dal (United),36870,132,37002,23.83,190
2,3,MADHU MANJARI,Rashtriya Lok Samta Party,5454,13,5467,3.52,190
3,4,DINANATH PANDIT,Lokpriya Samaj Party,1766,1,1767,1.14,190
4,5,NITU DEVI,Nation First Democratic Party,792,2,794,0.51,190
5,6,FUJALUR RAHAMAN ASARI,Jan Adhikar Party (Loktantrik),1078,6,1084,0.7,190
6,7,MANISH KUMAR,Shiv Sena,404,3,407,0.26,190
7,8,Manoj Kumar Upadhyay,Bharatiya Aam Awam Party,345,0,345,0.22,190
8,9,RAVINDRA PRASAD,Peoples Party of India (Democratic),370,1,371,0.24,190
9,10,RAVISH KUMAR,Bhartiya Sablog Party,1493,4,1497,0.96,190
10,11,RAJGIR PRASAD,Lok Sewa Dal,663,0,663,0.43,190
11,12,SANT KUMAR SINGH,Shoshit Samaj Dal,1443,0,1443,0.93,190
12,13,SANDEEP SAURAV,Communist Party of India  (Marxist-Leninist)  (Liberation),67798,119,67917,43.73,190
13,14,HARE KRISNA SINGH,Independent,1177,0,1177,0.76,190
14,15,ANITA DEVI,Independent,1086,0,1086,0.7,190
15,16,GOPAL CHAUDHARI,Independent,4440,4,4444,2.86,190
16,17,JITENDRA BIND,Independent,1274,0,1274,0.82,190
17,18,DHANANJAY KUMAR,Independent,1542,1,1543,0.99,190
18,19,BASANT KUMAR,Independent,745,2,747,0.48,190
19,20,MAHESH YADAV,Independent,364,0,364,0.23,190
20,21,RAKESH RANJAN,Independent,884,2,886,0.57,190
21,22,VENKATESH SHARMA,Independent,418,1,419,0.27,190
22,23,SRINIVAS KUMAR,Independent,732,1,733,0.47,190
23,24,SANJEET KUMAR,Independent,619,3,622,0.4,190
24,25,SUNIL KUMAR,Independent,5251,10,5261,3.39,190
25,26,NOTA,None of the Above,1876,5,1881,1.21,190
0,1,ATUL KUMAR,Bharatiya Janata Party,14232,207,14439,7.99,191
1,2,ARUN KUMAR,Bahujan Samaj Party,3350,13,3363,1.86,191
2,3,SIDDHARTH SAURAV,Indian National Congress,86001,176,86177,47.71,191
3,4,CHANDRASHEKHAR YADAV,Jan Adhikar Party,2023,4,2027,1.12,191
4,5,PUNAM DEVI,Satya Bahumat Party,799,3,802,0.44,191
5,6,VIKASH KUMAR,Rashtriya Jan Jan Party,704,7,711,0.39,191
6,7,VISHWNATH PRASAD,Janta Dal Rashtravadi,588,5,593,0.33,191
7,8,SUNIL KUMAR,Janata Party,1184,2,1186,0.66,191
8,9,ANIL KUMAR,Independent,50611,106,50717,28.08,191
9,10,ARVIND KUMAR,Independent,631,1,632,0.35,191
10,11,DILIP KUMAR,Independent,565,1,566,0.31,191
11,12,NAGENDRA KUMAR,Independent,11216,7,11223,6.21,191
12,13,MANOJ KUMAR,Independent,1169,1,1170,0.65,191
13,14,Dr. MAMTAMAYI PRIYADARSHINI,Independent,3062,6,3068,1.7,191
14,15,SURENDRA YADAV,Independent,2149,3,2152,1.19,191
15,16,NOTA,None of the Above,1803,11,1814,1,191
0,1,KIRAN DEVI,Rashtriya Janata Dal,78576,1023,79599,51.54,192
1,2,VIJAYENDRA YADAV,Janata Dal (United),28467,525,28992,18.77,192
2,3,SHIV SHANKAR PRASAD,Rashtriya Lok Samta Party,3301,50,3351,2.17,192
3,4,SHWETA SINGH,Lok Jan Shakti Party,28062,438,28500,18.45,192
4,5,AKHILESHWAR NATH TIWARI,Jan Sangh Party,1216,14,1230,0.8,192
5,6,KAMAL KUMAR SINGH,Voters Party  International,777,4,781,0.51,192
6,7,KRISHNA PASWAN,Bhartiya Kranti Vir Party,1707,13,1720,1.11,192
7,8,BABAN KUMAR,Jan Adhikar Party (Loktantrik),2578,25,2603,1.69,192
8,9,MANMOHAN SINGH,Rashtrawadi Janlok Party (Satya),1503,13,1516,0.98,192
9,10,SANTOSH KUMAR SINGH,Rashtriya Jan Jan Party,1638,22,1660,1.07,192
10,11,RAMDEO SINGH,Independent,1043,11,1054,0.68,192
11,12,NOTA,None of the Above,3405,44,3449,2.23,192
0,1,RAGHVENDRA PRATAP SINGH,Bharatiya Janata Party,74981,1201,76182,46.15,193
1,2,SAROJ YADAV,Rashtriya Janata Dal,70132,1077,71209,43.13,193
2,3,SIYAMATI RAI,Rashtriya Lok Samta Party,1234,14,1248,0.76,193
3,4,NIMESH SHUKLA,Janmat Party,619,19,638,0.39,193
4,5,RAGHUPATI YADAV,Jan Adhikar Party (Loktantrik),1333,20,1353,0.82,193
5,6,RAMTAHAL CHOUDHARY,"Log Jan Party - Secular,",530,6,536,0.32,193
6,7,ASHA DEVI,Independent,7063,140,7203,4.36,193
7,8,MOHD KALAM KHAN,Independent,552,8,560,0.34,193
8,9,GUPTESHWAR DUBEY,Independent,731,8,739,0.45,193
9,10,MANJEE KUMAR SHAH,Independent,2622,13,2635,1.6,193
10,11,NOTA,None of the Above,2761,23,2784,1.69,193
0,1,Amrendra Pratap singh,Bharatiya Janata Party,70355,1426,71781,45.05,194
1,2,Praveen Kumar Singh,Rashtriya Lok Samta Party,1126,34,1160,0.73,194
2,3,Anil Kumar Singh,Janata Party,699,17,716,0.45,194
3,4,Kajal Kumari,Akhand Bhartiya Yuva Party,619,12,631,0.4,194
4,5,Quyamuddin Ansari,Communist Party of India  (Marxist-Leninist)  (Liberation),67250,1529,68779,43.17,194
5,6,Gorakh Ram,Voters Party  International,1113,12,1125,0.71,194
6,7,Dilip Kumar Singh,Rashtrawadi Janlok Party (Satya),992,11,1003,0.63,194
7,8,Brajesh Kumar Singh,Jan Adhikar Party (Loktantrik),1185,36,1221,0.77,194
8,9,Kumar Ashutosh,Independent,352,7,359,0.23,194
9,10,Chandra Bhanu Gupta,Independent,621,10,631,0.4,194
10,11,Shabana,Independent,689,9,698,0.44,194
11,12,Sheodas Singh,Independent,2983,8,2991,1.88,194
12,13,Shobhnath Yadav,Independent,444,13,457,0.29,194
13,14,Sanjay Shekhar Shukla,Independent,604,5,609,0.38,194
14,15,Hakim Prasad,Independent,4280,80,4360,2.74,194
15,16,NOTA,None of the Above,2752,59,2811,1.76,194
0,1,PRABHUNATH PRASAD,Janata Dal (United),37232,545,37777,26.87,195
1,2,MANURAM RATHAUR,Rashtriya Lok Samta Party,1734,31,1765,1.26,195
2,3,RAJESHWAR PASWAN,Lok Jan Shakti Party,4861,111,4972,3.54,195
3,4,ASHOK RAM,Jai Maha Bharath Party,581,7,588,0.42,195
4,5,INDU DEVI,Bhartiya Party (Loktantrik),1578,23,1601,1.14,195
5,6,MANOJ MANZIL,Communist Party of India  (Marxist-Leninist)  (Liberation),85397,930,86327,61.39,195
6,7,SURAJ BHAN,Shoshit Samaj Dal,1397,6,1403,1,195
7,8,AMAR JYOTI,Independent,737,13,750,0.53,195
8,9,UPENDRA KUMAR,Independent,759,5,764,0.54,195
9,10,RAJMUNI DEVI,Independent,874,8,882,0.63,195
10,11,NOTA,None of the Above,3750,37,3787,2.69,195
0,1,Kaushal Kumar Vidyarthi,Bharatiya Janata Party,13536,297,13833,8.14,196
1,2,Santosh Singh Chandrawanshi,Rashtriya Lok Samta Party,2253,25,2278,1.34,196
2,3,Suryajeet Kumar Singh,Nationalist Congress Party,1148,23,1171,0.69,196
3,4,Anil Kumar,Jantantrik Vikas Party,6138,39,6177,3.64,196
4,5,Dinesh Mouar,Voters Party  International,1282,2,1284,0.76,196
5,6,Prakash Kumar,Shoshit Samaj Dal,763,3,766,0.45,196
6,7,Sanjay Rai,Jan Adhikar Party (Loktantrik),1131,5,1136,0.67,196
7,8,Sudama Prasad S/o Ganga Dayal Sah,Communist Party of India  (Marxist-Leninist)  (Liberation),73021,924,73945,43.53,196
8,9,Kumari Sanchana,Independent,2183,13,2196,1.29,196
9,10,Narendra Kumar Pandey @ Sunil Pandey,Independent,62423,507,62930,37.05,196
10,11,Sudama Prasad S/o Ramji Seth,Independent,1546,45,1591,0.94,196
11,12,NOTA,None of the Above,2536,14,2550,1.5,196
0,1,RAM VISHUN SINGH,Rashtriya Janata Dal,65643,989,66632,39.68,197
1,2,SHUSHUMLATA,Janata Dal (United),28913,449,29362,17.48,197
2,3,Dr. SHYAM NANDAN,Bahujan Samaj Party,3296,21,3317,1.98,197
3,4,SRIBHAGWAN SINGH KUSHWAHA,Lok Jan Shakti Party,44151,374,44525,26.51,197
4,5,AMARJEET KUMAR,Jai Prakash Janata Dal,902,8,910,0.54,197
5,6,GOPAL JEE SINGH,Janata Dal  (Secular),294,4,298,0.18,197
6,7,JITENDRA KUMAR,Satya Bahumat Party,275,3,278,0.17,197
7,8,DINESH KUMAR SINGH,Jan Adhikar Party (Loktantrik),3097,34,3131,1.86,197
8,9,NARAYAN SINGH,Voters Party  International,546,2,548,0.33,197
9,10,MOHAMMAD SAGIR AHMAD,Jantantrik Lokhit Party,697,5,702,0.42,197
10,11,RAJESHWAR SINGH,Proutist Sarva Samaj,470,3,473,0.28,197
11,12,RANA PRATAP SINGH,Bhartiya Sablog Party,756,5,761,0.45,197
12,13,SACHCHIDANAND SINGH,Janata Party,1950,10,1960,1.17,197
13,14,ANIL KUMAR SINGH,Independent,7138,111,7249,4.32,197
14,15,NARENDRA PRATAP SINGH,Independent,1409,5,1414,0.84,197
15,16,BINOD KUMAR,Independent,2528,1,2529,1.51,197
16,17,HARIBANSH PANDIT,Independent,2269,8,2277,1.36,197
17,18,HIRA LAL SINGH,Independent,749,3,752,0.45,197
18,19,NOTA,None of the Above,797,20,817,0.49,197
0,1,GUDIYA DEVI,Nationalist Congress Party,1320,18,1338,0.85,198
1,2,MUNNI DEVI,Bharatiya Janata Party,20774,581,21355,13.64,198
2,3,RAHUL TIWARY,Rashtriya Janata Dal,63518,875,64393,41.14,198
3,4,VED PRKASH,Rashtriya Lok Samta Party,2672,17,2689,1.72,198
4,5,NANHAK SINGH,Bahujan Mukti Party,454,2,456,0.29,198
5,6,MUNNA SHARMA,Moulik Adhikar Party,504,3,507,0.32,198
6,7,YASH TRIPATHI,Rashtra Sewa Dal,325,3,328,0.21,198
7,8,RAKESH KUMAR MISHRA,Jan Adhikar Party (Loktantrik),1290,36,1326,0.85,198
8,9,LAKSHMAN KUMAR OJHA,Bhartiya Rashtriya Dal,631,3,634,0.41,198
9,10,SHAMBHU PRASAD SHARMA,Hindustan Vikas Dal,315,2,317,0.2,198
10,11,SANTOSH KUMAR SRIVASTAV,Janata Party,2517,5,2522,1.61,198
11,12,HARENDRA SINGH,Rashtriya Jan Jan Party,3547,24,3571,2.28,198
12,13,KALIKA PRASAD SINGH,Independent,731,3,734,0.47,198
13,14,KUMAR AVINASH CHANDRA,Independent,2056,4,2060,1.32,198
14,15,KRISHNA RAM,Independent,1990,14,2004,1.28,198
15,16,KHYALEE  KUWOR,Independent,1198,0,1198,0.77,198
16,17,GANGADHAR PANDEY,Independent,3804,32,3836,2.45,198
17,18,GOUTTAM OJHA,Independent,471,2,473,0.3,198
18,19,BHUTESHWAR YADAV,Independent,2859,17,2876,1.84,198
19,20,MANNAN SAHA,Independent,387,0,387,0.25,198
20,21,MANOJ YADAV,Independent,433,7,440,0.28,198
21,22,SHOBHA DEVI,Independent,41134,376,41510,26.52,198
22,23,SANJEEV KUMAR PANDEY,Independent,593,3,596,0.38,198
23,24,NOTA,None of the Above,959,19,978,0.62,198
0,1,JATA DHARI @ JATA DHARI PASWAN,Bahujan Samaj Party,5443,41,5484,2.96,199
1,2,SHAMBHU NATH YADAV,Rashtriya Janata Dal,89059,1117,90176,48.64,199
2,3,HULAS PANDEY,Lok Jan Shakti Party,38522,513,39035,21.05,199
3,4,ANIL RAI @ BHAIYA JEE,Rashtriya Dal United,1795,64,1859,1,199
4,5,KAMALKANT SINGH,Jagrook Janta Party,684,9,693,0.37,199
5,6,JAIRAJ CHAUDHARY,Vikassheel Insaan Party,30273,209,30482,16.44,199
6,7,PARMA NAND YADAV,Jan Adhikar Party (Loktantrik),3160,22,3182,1.72,199
7,8,RANJAN KUMAR TIWARY,Rashtrawadi Jansangh,454,11,465,0.25,199
8,9,RAMESH KUMAR,Vanchit Samaj Party,1193,4,1197,0.65,199
9,10,TEJ NARAYAN TIWARI,Independent,858,8,866,0.47,199
10,11,NIRANJAN KUMAR SINGH,Independent,920,5,925,0.5,199
11,12,NILESH KUMAR RAHUL,Independent,2490,7,2497,1.35,199
12,13,BHARAT SHARMA @ BHARAT SHARMA VYAS,Independent,3361,18,3379,1.82,199
13,14,MANISH BHUSHAN OJHA,Independent,2837,26,2863,1.54,199
14,15,NOTA,None of the Above,2264,29,2293,1.24,199
0,1,Nirmal Kumar Singh,Rashtriya Lok Samta Party,30238,251,30489,18.67,200
1,2,Parshuram Chaubey,Bharatiya Janata Party,54830,695,55525,33.99,200
2,3,Sanjay Kr. Tiwari @ Munna Tiwari,Indian National Congress,58181,1236,59417,36.38,200
3,4,Ashwini Kumar Rai,Hindu Samaj Party,783,13,796,0.49,200
4,5,Ram Nath Thakur,Bhartiya Sablog Party,709,24,733,0.45,200
5,6,Sanjay Kumar Chaubey,Rashtriya Jan Jan Party,311,12,323,0.2,200
6,7,Arun Kumar Ojha,Independent,714,9,723,0.44,200
7,8,Aakash Kumar Singh,Independent,5717,77,5794,3.55,200
8,9,Kamal Narayan Yadav,Independent,400,6,406,0.25,200
9,10,Gobardhn Misara,Independent,1135,6,1141,0.7,200
10,11,Bheem Prasad,Independent,455,9,464,0.28,200
11,12,Ravi Raj,Independent,1456,5,1461,0.89,200
12,13,Raja Ram  Singh,Independent,1378,6,1384,0.85,200
13,14,Sudhakar Mishra,Independent,1046,8,1054,0.65,200
14,15,NOTA,None of the Above,3602,28,3630,2.22,200
0,1,ANJUM ARA,Janata Dal (United),46484,421,46905,26.81,201
1,2,AKHILESH KUMAR SINGH,Lok Jan Shakti Party,6373,101,6474,3.7,201
2,3,ARVIND PRATAP SHAHI @ BANTI SHAHI,Rashtriya Lok Samta Party,11445,72,11517,6.58,201
3,4,AJIT KUMAR SINGH,Communist Party of India  (Marxist-Leninist)  (Liberation),70338,982,71320,40.76,201
4,5,VIKASH SINGH,Rashtriya Jaihind Party,1620,8,1628,0.93,201
5,6,VINAY RAUT,Bhartiya Party (Loktantrik),902,11,913,0.52,201
6,7,SHREE KANT SINGH,Jan Adhikar Party (Loktantrik),1844,14,1858,1.06,201
7,8,ANSHU KUMARI,Independent,393,14,407,0.23,201
8,9,GANGA PRASAD,Independent,412,3,415,0.24,201
9,10,DADAN YADAV,Independent,9032,134,9166,5.24,201
10,11,PRIYESH KUMAR,Independent,461,6,467,0.27,201
11,12,MANORANJAN KUMAR PASWAN,Independent,1297,3,1300,0.74,201
12,13,MOHAMMAD AFZAL ANSARI,Independent,2960,1,2961,1.69,201
13,14,RAVI SHANKAR RAI,Independent,1071,2,1073,0.61,201
14,15,RAJARAM CHAUDHARI,Independent,1274,3,1277,0.73,201
15,16,SHIVANG VIJAY SINGH,Independent,9333,57,9390,5.37,201
16,17,SANTOSH KUMAR CHOUBEY,Independent,1761,2,1763,1.01,201
17,18,SUNIL KUMAR @ PAPPU YADAV,Independent,4213,52,4265,2.44,201
18,19,NOTA,None of the Above,1864,13,1877,1.07,201
0,1,NIRBHAYA KUMAR NIRALA,Lok Jan Shakti Party,7403,46,7449,4.03,202
1,2,VISHWANATH RAM,Indian National Congress,66957,914,67871,36.76,202
2,3,SANJAY RAM,Bahujan Samaj Party,43674,162,43836,23.74,202
3,4,SANTOSH KUMAR NIRALA,Janata Dal (United),46392,275,46667,25.28,202
4,5,ASHOK KUMAR RAM,Bahujan Mukti Party,1325,2,1327,0.72,202
5,6,ASHOK PASWAN,Rashtriya Jaihind Party,742,6,748,0.41,202
6,7,MOHAN RAM RAJAK,Peoples Party of India (Democratic),585,2,587,0.32,202
7,8,SAVINAY KUMAR,Bharatiya Aam Awam Party,967,2,969,0.52,202
8,9,SURAJ PRAKASH RAM,Sanyukt Kisan Vikas Party,885,0,885,0.48,202
9,10,HARE RAM PRASAD,Bhartiya Sablog Party,1439,2,1441,0.78,202
10,11,AJAD PASWAN,Independent,4270,6,4276,2.32,202
11,12,CHHEDI LAL RAM,Independent,2355,10,2365,1.28,202
12,13,NIKUNJ KUMAR ARYAN,Independent,1481,0,1481,0.8,202
13,14,NEELKAMAL PRASAD,Independent,1869,4,1873,1.01,202
14,15,NOTA,None of the Above,2829,12,2841,1.54,202
0,1,Ambika Singh,Bahujan Samaj Party,57589,305,57894,32.3,203
1,2,Ashok Kumar Singh,Bharatiya Janata Party,55750,334,56084,31.29,203
2,3,Ram Bachan Ram,Nationalist Congress Party,903,4,907,0.51,203
3,4,Sudhakar Singh,Rashtriya Janata Dal,57284,799,58083,32.4,203
4,5,Deepak Upadhyay,Bhartiya Sablog Party,584,0,584,0.33,203
5,6,Indresh Bahadur Singh,Independent,509,1,510,0.28,203
6,7,MD. Iliyas Ansari,Independent,189,3,192,0.11,203
7,8,Ram Bachan Singh,Independent,181,1,182,0.1,203
8,9,Ram Sudhakar Tiwary,Independent,381,0,381,0.21,203
9,10,Shankar Dayal Anand,Independent,862,2,864,0.48,203
10,11,Shahil Kumar,Independent,394,1,395,0.22,203
11,12,Sanjay Kumar Singh,Independent,1170,1,1171,0.65,203
12,13,NOTA,None of the Above,2015,4,2019,1.13,203
0,1,Niranjan Ram,Bharatiya Janata Party,48929,252,49181,30.39,204
1,2,Rajesh Kumar Ram,Nationalist Congress Party,766,5,771,0.48,204
2,3,Sangita Kumari,Rashtriya Janata Dal,60029,1206,61235,37.84,204
3,4,Suman Devi,Rashtriya Lok Samta Party,39659,196,39855,24.63,204
4,5,Anil Kumar,Akhil Bhartiya Apna Dal,740,3,743,0.46,204
5,6,Indrajit Ram,Rashtrawadi Janlok Party (Satya),1595,8,1603,0.99,204
6,7,Dadan Ram,Swaraj Party (Loktantrik),286,2,288,0.18,204
7,8,Ashwini Kumar,Independent,299,0,299,0.18,204
8,9,Dulesh Ram,Independent,382,0,382,0.24,204
9,10,Bechan Ram,Independent,495,4,499,0.31,204
10,11,Brajesh Kumar,Independent,1017,3,1020,0.63,204
11,12,Mukesh Kumar Raj,Independent,1220,5,1225,0.76,204
12,13,Sonu Kumari,Independent,863,1,864,0.53,204
13,14,NOTA,None of the Above,3860,11,3871,2.39,204
0,1,BIRENDRA KUMAR SINGH,Rashtriya Lok Samta Party,36780,234,37014,21.21,205
1,2,BHARAT BIND,Rashtriya Janata Dal,56562,999,57561,32.98,205
2,3,RINKI RANI PANDEY,Bharatiya Janata Party,47115,401,47516,27.22,205
3,4,SANJAY KUMAR SINHA,Nationalist Congress Party,639,1,640,0.37,205
4,5,CHTHU GOND,Ambedkarite Party of India,719,5,724,0.41,205
5,6,DIWAKER CHOUBEY,Rashtrawadi Janlok Party (Satya),1090,6,1096,0.63,205
6,7,POONAM SINGH URF DR. POONAM KUSHWAHA,Bahujan Mukti Party,306,8,314,0.18,205
7,8,MUKHTAR ANSARI,Peace Party,269,6,275,0.16,205
8,9,RAMCHANDR SINGH YADAV,Jan Adhikar Party (Loktantrik),1162,11,1173,0.67,205
9,10,UJJWAL KUMAR CHAUBAY,Independent,711,8,719,0.41,205
10,11,KRISHNAKANT TIWARI,Independent,668,1,669,0.38,205
11,12,DOCTOR PRAMOD KUMAR SINGH,Independent,20368,271,20639,11.83,205
12,13,NARENDRA PRATAP SINGH,Independent,1133,0,1133,0.65,205
13,14,STYENDRA KUMAR DUBEY,Independent,1389,1,1390,0.8,205
14,15,NOTA,None of the Above,3660,11,3671,2.1,205
0,1,MOHD. ZAMA KHAN,Bahujan Samaj Party,94296,949,95245,46.24,206
1,2,PRAKASH KUMAR SINGH,Indian National Congress,5316,98,5414,2.63,206
2,3,BRIJ KISHOR BIND,Bharatiya Janata Party,70646,305,70951,34.45,206
3,4,DEENDAYAL SINGH KUSHWAHA,Bhartiya Lokmat Rashtrwadi Party,1240,1,1241,0.6,206
4,5,PUSHPA DEVI,Sapaks Party,513,1,514,0.25,206
5,6,PRABHU SINGH,"Rashtriya Swatantra Party,",923,1,924,0.45,206
6,7,RAJPUT DHARMENDRA SINGH,Rashtrawadi Janlok Party (Satya),951,10,961,0.47,206
7,8,RAM RAJ SHARMA,"Log Jan Party - Secular,",1870,5,1875,0.91,206
8,9,RENU DEVI,Hindu Samaj Party,1446,12,1458,0.71,206
9,10,SHIV SHANKAR SINGH,Rashtra Sewa Dal,1125,2,1127,0.55,206
10,11,SAHNAWAJ ANSARI,Peace Party,340,4,344,0.17,206
11,12,RITURAJ PATEL,Independent,841,6,847,0.41,206
12,13,DIWAN ARSHAD HUSAIN KHAN,Independent,2264,10,2274,1.1,206
13,14,NIRAJ PANDEY,Independent,13038,81,13119,6.37,206
14,15,PRAHALAD BIND,Independent,2023,2,2025,0.98,206
15,16,MAJANU GOND,Independent,4188,3,4191,2.03,206
16,17,MADAN RAM,Independent,1565,0,1565,0.76,206
17,18,RAMLAL SINGH,Independent,485,0,485,0.24,206
18,19,VISHWANATH BIND,Independent,809,2,811,0.39,206
19,20,NOTA,None of the Above,595,4,599,0.29,206
0,1,CHANDRA SHEKHAR PASWAN,Lok Jan Shakti Party,17970,104,18074,10.4,207
1,2,BHAJURAM,Nationalist Congress Party,816,11,827,0.48,207
2,3,MURARI PRASAD GAUTAM,Indian National Congress,70933,768,71701,41.25,207
3,4,LALAN PASWAN,Janata Dal (United),53444,254,53698,30.89,207
4,5,SHYAM BIHARI RAM,Bahujan Samaj Party,12801,63,12864,7.4,207
5,6,GANESH PASWAN,Rashtra Sewa Dal,686,6,692,0.4,207
6,7,PACHMUNA DEVI,Bahujan Mukti Party,590,9,599,0.34,207
7,8,SANJAY KUMAR,Ambedkarite Party of India,1332,5,1337,0.77,207
8,9,HARENDRA KUMAR,Azad Samaj Party,797,5,802,0.46,207
9,10,DHARM DEV RAM,Independent,1310,2,1312,0.75,207
10,11,PRAMOD KUMAR,Independent,664,3,667,0.38,207
11,12,BABY DEVI,Independent,1232,3,1235,0.71,207
12,13,MANISH KUMAR RAJAK,Independent,3061,7,3068,1.77,207
13,14,RAM ADHAR PASWAN,Independent,2548,1,2549,1.47,207
14,15,RAMEKBAL RAM,Independent,945,3,948,0.55,207
15,16,NOTA,None of the Above,3430,20,3450,1.98,207
0,1,ASHOK KUMAR,Janata Dal (United),56448,432,56880,31.78,208
1,2,ASHUTOSH SINGH,Nationalist Congress Party,1074,21,1095,0.61,208
2,3,RAJESH KUMAR GUPTA,Rashtriya Janata Dal,82227,1076,83303,46.54,208
3,4,RAMESHWAR PRASAD,Lok Jan Shakti Party,21265,161,21426,11.97,208
4,5,AJAY KUMAR SINGH,Sanyukt Vikas Party,697,3,700,0.39,208
5,6,ARVIND SINGH,Rashtriya Samanta Dal,407,1,408,0.23,208
6,7,ARUN KUMAR,Hindu Samaj Party,377,4,381,0.21,208
7,8,JAGTENDU KUMAR,Rashtra Sewa Dal,408,3,411,0.23,208
8,9,BADAL KUMAR,Bahujan Mukti Party,561,14,575,0.32,208
9,10,YAMUNA CHOUDHARY,All India Minorities Front,629,5,634,0.35,208
10,11,RAJIV RANJAN TUTUL,Bhartiya Sablog Party,859,9,868,0.48,208
11,12,LAKSHMI DEVI,Proutist Sarva Samaj,457,3,460,0.26,208
12,13,AMLA TRIPATHI,Independent,1463,13,1476,0.82,208
13,14,UDAY AMAR SINGH,Independent,1414,1,1415,0.79,208
14,15,URMILA KUER,Independent,430,0,430,0.24,208
15,16,DEEN DAYAL SINGH,Independent,2176,2,2178,1.22,208
16,17,MUNESHWAR GUPTA,Independent,2462,1,2463,1.38,208
17,18,RAM SAGAR DWIVEDY,Independent,490,0,490,0.27,208
18,19,SATYANAND KUMAR,Independent,1687,4,1691,0.94,208
19,20,SATYENDRA KUMAR SATYA,Independent,613,3,616,0.34,208
20,21,NOTA,None of the Above,1079,14,1093,0.61,208
0,1,UDAY PRATAP SINGH,Bahujan Samaj Party,47065,256,47321,24.35,209
1,2,RAKESH KUMAR SINGH,Lok Jan Shakti Party,16907,81,16988,8.74,209
2,3,BASHISTH SINGH,Janata Dal (United),55351,329,55680,28.66,209
3,4,SANTOSH KUMAR MISHRA,Indian National Congress,59017,746,59763,30.76,209
4,5,NARAD SETH,Rashtra Sewa Dal,1161,3,1164,0.6,209
5,6,MOHAMMAD SHAKIL ANSARI,Sanyukt Vikas Party,374,3,377,0.19,209
6,7,RAVI PATEL,Rashtrawadi Janlok Party (Satya),245,2,247,0.13,209
7,8,VINDHYACHAL DEVI,Bhartiya Sablog Party,640,3,643,0.33,209
8,9,SHAILESH KUMAR,Bharatiya Aam Awam Party,409,0,409,0.21,209
9,10,SANJAY CHOUBEY,Rashtriya Jaihind Party,230,4,234,0.12,209
10,11,SIMA KUMARI,Jan Adhikar Party (Loktantrik),1487,26,1513,0.78,209
11,12,SAURABH TIWARI,Bhartiya Lokmat Rashtrwadi Party,483,0,483,0.25,209
12,13,ARVIND KUMAR SINGH,Independent,1436,7,1443,0.74,209
13,14,KAMALA SINGH,Independent,1016,0,1016,0.52,209
14,15,DEEPAK KUMAR,Independent,647,0,647,0.33,209
15,16,NEERAJ SHUKLA,Independent,1594,0,1594,0.82,209
16,17,PARAMHANS TIWARI,Independent,896,0,896,0.46,209
17,18,RAMASHANKAR TIWARI,Independent,717,0,717,0.37,209
18,19,RINKU KUMARI,Independent,1560,0,1560,0.8,209
19,20,LAL DHARI SINGH,Independent,894,0,894,0.46,209
20,21,NOTA,None of the Above,705,4,709,0.36,209
0,1,JAI KUMAR SINGH,Janata Dal (United),27009,243,27252,16,210
1,2,RAJENDRA PRASAD SINGH,Lok Jan Shakti Party,51025,288,51313,30.13,210
2,3,RAJESH SINGH,Rashtriya Lok Samta Party,18297,71,18368,10.79,210
3,4,VIJAY KUMAR MANDAL,Rashtriya Janata Dal,58921,620,59541,34.97,210
4,5,ARUN KUMAR SINGH,Jan Adhikar Party (Loktantrik),896,8,904,0.53,210
5,6,JOKHU PASWAN,Bahujan Mukti Party,412,3,415,0.24,210
6,7,RAJENDRA SAH,Shoshit Samaj Dal,282,1,283,0.17,210
7,8,RAMESAR NONIYA,Rashtriya Janwadi Party (Socialist),446,0,446,0.26,210
8,9,SATYENDRA AMRTY KATYAYAN,Rashtrawadi Janlok Party (Satya),303,3,306,0.18,210
9,10,SITA SUNDARI KUMARI,Rashtriya Janshakti Party (Secular),180,4,184,0.11,210
10,11,SUNANDA SINGH,Bhartiya Sablog Party,309,1,310,0.18,210
11,12,AJAY KUMAR SINGH,Independent,841,1,842,0.49,210
12,13,ANIL KUMAR SINGH,Independent,1163,2,1165,0.68,210
13,14,ARBIND KUMAR PANDEY,Independent,915,4,919,0.54,210
14,15,NIRANJAN KUMAR RAY,Independent,1566,1,1567,0.92,210
15,16,BHUPESH SINGH,Independent,1430,1,1431,0.84,210
16,17,MRITUNJAY PANDEY,Independent,1011,1,1012,0.59,210
17,18,RAJESH KUMAR RAM,Independent,1677,4,1681,0.99,210
18,19,HARENDRA SINGH,Independent,813,1,814,0.48,210
19,20,NOTA,None of the Above,1522,5,1527,0.9,210
0,1,AKHILESHWAR PRASAD SINGH,Rashtriya Lok Samta Party,10227,48,10275,6.91,211
1,2,ANITA DEVI,Rashtriya Janata Dal,64890,800,65690,44.15,211
2,3,KRISHNA KABIR,Lok Jan Shakti Party,12230,83,12313,8.28,211
3,4,NAGENDRA CHANDRAWANSI,Janata Dal (United),47678,340,48018,32.27,211
4,5,SURENDRA PANDEY,Nationalist Congress Party,573,8,581,0.39,211
5,6,ANITA YADAV,Jan Adhikar Party (Loktantrik),1172,23,1195,0.8,211
6,7,ANIRUDH KUMAR,Peoples Party of India (Democratic),507,4,511,0.34,211
7,8,KAMLESH KUMAR MISHRA,Bhartiya Sablog Party,841,2,843,0.57,211
8,9,JBBAR ANSARI,Bharatiya Momin Front,300,1,301,0.2,211
9,10,DHARMENDRA KUMAR SINGH,Rashtriya Samanta Dal,399,3,402,0.27,211
10,11,RANJAN KUMAR CHOUDHARY,Janshakti Vikas Party (Democratic),688,3,691,0.46,211
11,12,ROUSHAN CHAUDHARI,Rashtra Sewa Dal,836,2,838,0.56,211
12,13,SHASHi KANT GUPTA,Bharatiya Aam Awam Party,1519,2,1521,1.02,211
13,14,ARTI DEVI,Independent,2140,24,2164,1.45,211
14,15,SYAD SHER JAHAN,Independent,1644,2,1646,1.11,211
15,16,NOTA,None of the Above,1786,12,1798,1.21,211
0,1,PHATE BAHADUR SINGH,Rashtriya Janata Dal,63802,765,64567,41.57,212
1,2,SATYANARAYAN SINGH,Bharatiya Janata Party,63721,382,64103,41.27,212
2,3,SONA DEVI,Bahujan Samaj Party,5980,47,6027,3.88,212
3,4,PRADEEP KUMAR JOSHI,Rashtra Sewa Dal,9004,66,9070,5.84,212
4,5,RANJEET KUMAR PATEL,Prabal Bharat Party,269,0,269,0.17,212
5,6,RAMENDRA KUMAR,Jawan Kisan Morcha,244,1,245,0.16,212
6,7,SAMEER KUMAR,Jan Adhikar Party (Loktantrik),628,5,633,0.41,212
7,8,UMA SHANKAR TIWARI,Independent,424,4,428,0.28,212
8,9,OM PRAKASH SINGH,Independent,456,2,458,0.29,212
9,10,GOPAL KRISHNA RAI,Independent,471,1,472,0.3,212
10,11,DINESH SHARMA,Independent,629,4,633,0.41,212
11,12,PREM PRAKASH,Independent,977,6,983,0.63,212
12,13,RAJIV RANJAN KUMAR,Independent,3677,29,3706,2.39,212
13,14,SHIV GANDHI,Independent,1585,3,1588,1.02,212
14,15,NOTA,None of the Above,2134,11,2145,1.38,212
0,1,MALTI SINGH,Rashtriya Lok Samta Party,4865,36,4901,2.86,213
1,2,RAJESHWAR RAJ,Bharatiya Janata Party,63989,522,64511,37.59,213
2,3,AMIT KUMAR SINGH,Rashtrawadi Janlok Party (Satya),5609,36,5645,3.29,213
3,4,ARUN SINGH,Communist Party of India  (Marxist-Leninist)  (Liberation),81808,892,82700,48.19,213
4,5,UMESH KUMAR,Jan Adhikar Party (Loktantrik),1342,5,1347,0.78,213
5,6,LAL BAHADUR YADAV,SOCIALIST UNITY CENTRE OF INDIA (COMMUNIST),358,3,361,0.21,213
6,7,Ashok Kumar Singh,Independent,1991,9,2000,1.17,213
7,8,DHARMENDRA KUMAR RAM,Independent,492,7,499,0.29,213
8,9,Baban Singh,Independent,405,2,407,0.24,213
9,10,BINAY KUMAR,Independent,593,0,593,0.35,213
10,11,Bansidhar Singh,Independent,2161,1,2162,1.26,213
11,12,Sweta Singh,Independent,958,5,963,0.56,213
12,13,HARE RAM SINGH,Independent,2527,1,2528,1.47,213
13,14,NOTA,None of the Above,3003,7,3010,1.75,213
0,1,Dipak Kumar Sharma,Bharatiya Janata Party,47873,463,48336,33.4,214
1,2,Subhash Chandra Yadav,Rashtriya Lok Samta Party,7867,74,7941,5.49,214
2,3,Anil Kumar Pandit,Rashtra Sewa Dal,909,2,911,0.63,214
3,4,Aunrag Kumar,Peoples Party of India (Democratic),488,12,500,0.35,214
4,5,Abhishek Ranjan,Jan Adhikar Party (Loktantrik),1291,18,1309,0.9,214
5,6,Kameshwar Thakur,Bahujan Mukti Party,641,11,652,0.45,214
6,7,Krishna Kishore,Janata Dal  (Secular),940,5,945,0.65,214
7,8,Maha Nand Singh,Communist Party of India  (Marxist-Leninist)  (Liberation),67524,762,68286,47.18,214
8,9,Mohan Kumar,Janata Party,2588,6,2594,1.79,214
9,10,Vimala Kumari,Bhartiya Sablog Party,1316,21,1337,0.92,214
10,11,Vimlesh Kumar,Pragatisheel Magahi Samaj,461,5,466,0.32,214
11,12,Md Shabbir Alam,Bahujan Lok Dal,359,4,363,0.25,214
12,13,Sanjay Kumar,Akhil Hind Forward Bloc (Krantikari),633,3,636,0.44,214
13,14,Sikandar  Kumar,Jagrook Janta Party,907,4,911,0.63,214
14,15,Subhash Sharma,Apna Kisan Party,784,8,792,0.55,214
15,16,Ajay Kumar,Independent,2339,3,2342,1.62,214
16,17,Anita Kumari,Independent,1493,5,1498,1.03,214
17,18,Kumar Gaurav,Independent,262,1,263,0.18,214
18,19,Gorakh Rajwar,Independent,530,0,530,0.37,214
19,20,Bhim Paswan,Independent,441,3,444,0.31,214
20,21,Vikash Kumar,Independent,260,0,260,0.18,214
21,22,Shashi Bhushan Sinha,Independent,240,0,240,0.17,214
22,23,Shah Imran Ahmad,Independent,807,5,812,0.56,214
23,24,NOTA,None of the Above,2357,15,2372,1.64,214
0,1,PAPPU KUMAR VERMA,Rashtriya Lok Samta Party,16107,51,16158,11.78,215
1,2,BAGI KUMAR VERMA,Rashtriya Janata Dal,53773,454,54227,39.54,215
2,3,BHUWNESHWAR PATHAK,Lok Jan Shakti Party,20414,95,20509,14.95,215
3,4,SHAFIQUL RAHMAN,Nationalist Congress Party,749,3,752,0.55,215
4,5,SATYADEO SINGH,Janata Dal (United),26231,186,26417,19.26,215
5,6,ALOK KUMAR,Jagrook Janta Party,433,1,434,0.32,215
6,7,JAMALUDIN ANSARI,Jan Adhikar Party (Loktantrik),2065,14,2079,1.52,215
7,8,RAJENDRA YADAV,Loktantrik Janta Dal,1386,6,1392,1.01,215
8,9,RUPESH KUMAR,SOCIALIST UNITY CENTRE OF INDIA (COMMUNIST),478,0,478,0.35,215
9,10,SUCHITRA SINHA,Bhartiya Sablog Party,1563,11,1574,1.15,215
10,11,SUNIL KUMAR,Peoples Party of India (Democratic),473,4,477,0.35,215
11,12,SUBHASH SAW,Rashtriya Samajhit Dal,1080,2,1082,0.79,215
12,13,AJAY KUMAR,Independent,1612,4,1616,1.18,215
13,14,MD ABDULLAH JAMAL MALIK,Independent,1496,3,1499,1.09,215
14,15,DEEPAK KUMAR,Independent,1289,2,1291,0.94,215
15,16,RAMPRAVESH YADAV,Independent,1671,6,1677,1.22,215
16,17,VINOD SHARMA,Independent,770,1,771,0.56,215
17,18,SANTOSH KUMAR SINGH,Independent,2790,12,2802,2.04,215
18,19,SUBASH SINGH,Independent,708,1,709,0.52,215
19,20,NOTA,None of the Above,1195,5,1200,0.87,215
0,1,Indu Devi Kashyap,Lok Jan Shakti Party,23828,348,24176,15.15,216
1,2,Kumar Krishna Mohan urf Suday Yadav,Rashtriya Janata Dal,73962,1068,75030,47.03,216
2,3,Krishannandan Prasad Verma,Janata Dal (United),40563,565,41128,25.78,216
3,4,Manoj Kumar Singh,Bahujan Samaj Party,3911,34,3945,2.47,216
4,5,Anil Kumar Singh,Janata Dal  (Secular),459,10,469,0.29,216
5,6,Amit Kumar,Pragatisheel Magahi Samaj,301,6,307,0.19,216
6,7,Kalam uddin,Rashtriya Jan Jan Party,691,15,706,0.44,216
7,8,Devendra Prasad,Apna Kisan Party,430,5,435,0.27,216
8,9,Mritunjay Kumar,Bhartiya Sablog Party,2858,45,2903,1.82,216
9,10,Raju Kumar,SOCIALIST UNITY CENTRE OF INDIA (COMMUNIST),634,4,638,0.4,216
10,11,Sachida nand Sinha,Janta Raj Vikas Party,838,11,849,0.53,216
11,12,Satish Kumar,Republican Party of India (Athawale),911,6,917,0.57,216
12,13,Sultan Amhad,Jan Adhikar Party (Loktantrik),1795,14,1809,1.13,216
13,14,Sanjay Kumar,Independent,1817,5,1822,1.14,216
14,15,Sijantri Kumari,Independent,2013,13,2026,1.27,216
15,16,NOTA,None of the Above,2368,20,2388,1.5,216
0,1,RAKESH KUMAR SINGH,Lok Jan Shakti Party,4671,91,4762,3.13,217
1,2,RAHUL KUMAR,Janata Dal (United),55759,1620,57379,37.68,217
2,3,INDRAJEET KUMAR SUDHAKAR,Jai Maha Bharath Party,1002,17,1019,0.67,217
3,4,JAYANT KUMAR,Bhartiya Sablog Party,1290,43,1333,0.88,217
4,5,RAM BALI SINGH YADAV,Communist Party of India  (Marxist-Leninist)  (Liberation),73563,1149,74712,49.07,217
5,6,ARVIND KUMAR,Independent,1642,10,1652,1.08,217
6,7,JYOTI KUMARI,Independent,1062,29,1091,0.72,217
7,8,NITYANANDA,Independent,2309,19,2328,1.53,217
8,9,MANI BHUSHAN SHARMA,Independent,651,15,666,0.44,217
9,10,SANJIT KUMAR SINGH,Independent,796,7,803,0.53,217
10,11,SATYENDRA PRASAD YADAV,Independent,2705,24,2729,1.79,217
11,12,NOTA,None of the Above,3763,30,3793,2.49,217
0,1,Byas muni das,Bahujan Samaj Party,4939,86,5025,3.65,218
1,2,Satish Kumar,Rashtriya Janata Dal,69865,1706,71571,52.01,218
2,3,AVADH PASWAN,Nation First Democratic Party,1730,63,1793,1.3,218
3,4,DEVENDRA KUMAR,Hindustani Awam Morcha (Secular),48171,835,49006,35.62,218
4,5,FUL CHAND MANJHI,Sanyukt Kisan Vikas Party,1294,53,1347,0.98,218
5,6,SHRAVAN MANJHI,Jagrook Janta Party,690,51,741,0.54,218
6,7,Dharmendra Kumar,Independent,3106,94,3200,2.33,218
7,8,Mukesh Dayal,Independent,1115,25,1140,0.83,218
8,9,Ranjit Paswan,Independent,1551,29,1580,1.15,218
9,10,NOTA,None of the Above,2144,52,2196,1.6,218
0,1,BHIM KUMAR SINGH,Rashtriya Janata Dal,81005,405,81410,44.07,219
1,2,MANOJ KUMAR,Bharatiya Janata Party,45628,164,45792,24.79,219
2,3,DR. RANVIJAY KUMAR,Rashtriya Lok Samta Party,43892,158,44050,23.85,219
3,4,MD. EKLAKH,Peace Party,1191,2,1193,0.65,219
4,5,DHARMENDRA KUMAR,Rashtra Sewa Dal,367,0,367,0.2,219
5,6,RAJESH RANJAN,Jai Maha Bharath Party,194,0,194,0.11,219
6,7,SHYAM SUNDER,Jan Adhikar Party (Loktantrik),183,0,183,0.1,219
7,8,SLENDRA BIHARI,Shoshit Samaj Dal,258,0,258,0.14,219
8,9,ABHIRAM PRIYADARSHI,Independent,204,0,204,0.11,219
9,10,CHITRANJAN SHARMA,Independent,175,0,175,0.09,219
10,11,DINESH KUMAR SINGH,Independent,308,0,308,0.17,219
11,12,MANISH KUMAR,Independent,323,0,323,0.17,219
12,13,MANOJ SHARMA,Independent,576,1,577,0.31,219
13,14,YUDHISTHIR NONIA,Independent,1643,1,1644,0.89,219
14,15,"RAJESH KUMAR, SON OF NUNU SHARMA",Independent,1642,0,1642,0.89,219
15,16,"RAJESH KUMAR, SON OF MADAN SINGH",Independent,3067,0,3067,1.66,219
16,17,SREEKANT SHARMA,Independent,1678,0,1678,0.91,219
17,18,NOTA,None of the Above,1662,1,1663,0.9,219
0,1,AJAY KUMAR,Rashtriya Lok Samta Party,19809,70,19879,11.32,220
1,2,RISHI KUMAR,Rashtriya Janata Dal,63032,630,63662,36.24,220
2,3,PRAKASH CHANDRA,Lok Jan Shakti Party,40799,195,40994,23.34,220
3,4,SUNIL KUMAR,Janata Dal (United),25016,218,25234,14.36,220
4,5,RABINDRA NATH SHARMA,Vanchit Samaj Party,1084,5,1089,0.62,220
5,6,RANA PRATAP SINGH,Bhartiya Sablog Party,1110,4,1114,0.63,220
6,7,RAMRUP RAJVANSHI,Akhil Hind Forward Bloc (Krantikari),1062,1,1063,0.61,220
7,8,SUJEET KUMAR,Jan Adhikar Party (Loktantrik),4047,19,4066,2.31,220
8,9,SOM PRAKASH,Swaraj Party (Loktantrik),7016,19,7035,4,220
9,10,PRAMOD SINGH CHANDRAVANSHI,Independent,7712,24,7736,4.4,220
10,11,NOTA,None of the Above,3787,6,3793,2.16,220
0,1,GOPAL NISHAD,Nationalist Congress Party,1427,3,1430,0.9,221
1,2,DHARMENDRA KUMAR,Rashtriya Lok Samta Party,23466,24,23490,14.71,221
2,3,VIJAY KUMAR SINGH,Lok Jan Shakti Party,9119,21,9140,5.72,221
3,4,VIJAY KUMAR SINGH ALIAS DABLOO SINGH,Rashtriya Janata Dal,64586,357,64943,40.68,221
4,5,VIRENDRA KUMAR SINGH,Janata Dal (United),44660,162,44822,28.07,221
5,6,BABAN KUMAR,Jan Adhikar Party (Loktantrik),1973,4,1977,1.24,221
6,7,BHASHKAR KUMAR VERMA,Pragatisheel Magahi Samaj,672,1,673,0.42,221
7,8,MALTI DEVI,Swaraj Party (Loktantrik),554,2,556,0.35,221
8,9,RANJAN KUMAR TIWARI,Rashtriya Jan Jan Party,1253,1,1254,0.79,221
9,10,ANUJ KUMAR SINGH,Independent,1755,1,1756,1.1,221
10,11,DEVPUJAN PRASAD,Independent,2993,1,2994,1.88,221
11,12,RANJAN KUMAR,Independent,1664,1,1665,1.04,221
12,13,SANJU DEVI,Independent,1586,3,1589,1,221
13,14,NOTA,None of the Above,3364,4,3368,2.11,221
0,1,KRISHNA RAM,Bahujan Samaj Party,3986,11,3997,2.88,222
1,2,RAJESH KUMAR,Indian National Congress,50424,398,50822,36.61,222
2,3,SARUN PASWAN,Lok Jan Shakti Party,11763,37,11800,8.5,222
3,4,ANIL KUMAR,Jan Adhikar Party (Loktantrik),1674,8,1682,1.21,222
4,5,YUGESH RAM,Bharatiya Momin Front,1058,0,1058,0.76,222
5,6,VIKASH KUMAR PASWAN,Bhartiya Sarvodaya Party,1285,4,1289,0.93,222
6,7,SHAILESH RAHI,Akhil Hind Forward Bloc (Krantikari),1006,0,1006,0.72,222
7,8,SHARWAN BHUIYA,Hindustani Awam Morcha (Secular),34094,75,34169,24.61,222
8,9,HARIKRISHNA PASWAN,Bahujan Mukti Party,2294,10,2304,1.66,222
9,10,NAGENDRA PRASAD,Independent,886,0,886,0.64,222
10,11,RANJEET SAGAR,Independent,1795,1,1796,1.29,222
11,12,LALAN RAM,Independent,20366,67,20433,14.72,222
12,13,VIKESH PASWAN,Independent,2134,0,2134,1.54,222
13,14,SATEYENDRA RAM,Independent,2862,1,2863,2.06,222
14,15,NOTA,None of the Above,2583,3,2586,1.86,222
0,1,ANIL KUMAR,Bahujan Samaj Party,18335,109,18444,10.87,223
1,2,ANAND SHANKAR SINGH,Indian National Congress,69472,546,70018,41.27,223
2,3,RAMADHAR SINGH,Bharatiya Janata Party,67409,366,67775,39.95,223
3,4,ARCHANA DEVI,Pragatisheel Magahi Samaj,1611,3,1614,0.95,223
4,5,ASHISH KUMAR SONI,Rashtra Sewa Dal,857,0,857,0.51,223
5,6,CHANDESH PD GUPTA,Jan Adhikar Party (Loktantrik),2242,12,2254,1.33,223
6,7,MAHESHWAR PASWAN,Akhil Hind Forward Bloc (Krantikari),1230,2,1232,0.73,223
7,8,SURESH PRASAD,Bahujan Mukti Party,2358,8,2366,1.39,223
8,9,SANJIV KUMAR SINGH,Independent,2606,4,2610,1.54,223
9,10,NOTA,None of the Above,2479,5,2484,1.46,223
0,1,ASHOK KUMAR SINGH,Janata Dal (United),26606,227,26833,14.5,224
1,2,MANOJ KUMAR SINGH,Lok Jan Shakti Party,8459,32,8491,4.59,224
2,3,MOHAMMAD NEHALUDDIN,Rashtriya Janata Dal,62886,439,63325,34.22,224
3,4,RANJIT KUMAR,Bahujan Samaj Party,14558,39,14597,7.89,224
4,5,VISHAL KUMAR SINGH,Nationalist Congress Party,818,7,825,0.45,224
5,6,ARMAN KHAN,Bhartiya Sablog Party,690,1,691,0.37,224
6,7,RAVI SHANKAR KUMAR,Voters Party  International,1038,1,1039,0.56,224
7,8,RAJ KUMAR,Rashtra Sewa Dal,1172,0,1172,0.63,224
8,9,RAMJEE SINGH KANTA,Akhil Hind Forward Bloc (Krantikari),619,3,622,0.34,224
9,10,VIJAY KUMAR,Jai Maha Bharath Party,701,1,702,0.38,224
10,11,SANDEEP SINGH SAMDARSHI,Jan Adhikar Party (Loktantrik),1618,1,1619,0.87,224
11,12,ASHOK KUMAR SINGH,Independent,1010,4,1014,0.55,224
12,13,ARIF RAJA,Independent,4866,6,4872,2.63,224
13,14,PRAMOD KUMAR SINGH,Independent,53667,229,53896,29.12,224
14,15,SANTOSH KUMAR URF SANTOSH KUSHWAHA,Independent,2161,4,2165,1.17,224
15,16,NOTA,None of the Above,3189,1,3190,1.72,224
0,1,Raghvendra Narayan Yadav,Bahujan Samaj Party,15161,74,15235,8.52,225
1,2,Rajiv Nandan,Bharatiya Janata Party,63740,422,64162,35.86,225
2,3,Ramadhar Singh,Nationalist Congress Party,1433,5,1438,0.8,225
3,4,Vinay Kumar,Rashtriya Janata Dal,69892,869,70761,39.55,225
4,5,Ajay Kumar,Pragatisheel Magahi Samaj,1098,3,1101,0.62,225
5,6,Arvind Kumar,Peoples Party of India (Democratic),489,3,492,0.27,225
6,7,Ashok Kumar Singh,Bhartiya Lok Chetna Party,332,1,333,0.19,225
7,8,Md. Azaj,Bahujan Lok Dal,1296,10,1306,0.73,225
8,9,Dinanath Prasad,Aam Janta Party Rashtriya,612,2,614,0.34,225
9,10,Brajesh Pandey,Rashtra Sewa Dal,398,3,401,0.22,225
10,11,Bhim Prasad,Rashtrawadi Janlok Party (Satya),616,12,628,0.35,225
11,12,Mithilesh Kumar Sharma,All India Forward Bloc,866,7,873,0.49,225
12,13,Yugesh Paswan,Rashtriya Samaj Paksha,2330,6,2336,1.31,225
13,14,Raja Ram Azad,Bhartiya Lok Nayak Party,987,4,991,0.55,225
14,15,Ramashray Ravidas,Akhil Hind Forward Bloc (Krantikari),1794,1,1795,1,225
15,16,Sudhir Kumar Verma,Jan Adhikar Party (Loktantrik),7373,71,7444,4.16,225
16,17,Arvind Kumar Srivastwa,Independent,1890,15,1905,1.06,225
17,18,Uday Kumar Verma,Independent,1055,2,1057,0.59,225
18,19,Krishan Deo Singh,Independent,682,3,685,0.38,225
19,20,Dilip Kumar Singh,Independent,1535,1,1536,0.86,225
20,21,Ranjan Kumar Barnwal,Independent,801,1,802,0.45,225
21,22,Binay Kumar,Independent,1650,16,1666,0.93,225
22,23,Vinod Paswan,Independent,397,2,399,0.22,225
23,24,NOTA,None of the Above,949,9,958,0.54,225
0,1,Manju Agrawal,Rashtriya Janata Dal,61419,385,61804,35.74,226
1,2,Mukesh Kumar Yadav,Lok Jan Shakti Party,24037,70,24107,13.94,226
2,3,Vinod Prasad Yadav,Janata Dal (United),44970,144,45114,26.09,226
3,4,Omair Khan,Jan Adhikar Party (Loktantrik),11779,26,11805,6.83,226
4,5,Karan Raj,Ambedkarite Party of India,1054,4,1058,0.61,226
5,6,Masaroor Alam,All India Majlis-E-Ittehadul Muslimeen,14951,36,14987,8.67,226
6,7,Vinod Kumar Singh,Peoples Party of India (Democratic),975,6,981,0.57,226
7,8,Chandradev Kumar Yadav,Independent,738,1,739,0.43,226
8,9,Manju Devi,Independent,1174,0,1174,0.68,226
9,10,Mukesh Prasad,Independent,3330,1,3331,1.93,226
10,11,Ramchandra Prasad Yadav,Independent,2651,1,2652,1.53,226
11,12,NOTA,None of the Above,5192,2,5194,3,226
0,1,Uday Narain Choudhary,Rashtriya Janata Dal,62332,396,62728,36.12,227
1,2,Kumari Shobha Sinha,Lok Jan Shakti Party,14150,47,14197,8.18,227
2,3,Jitendra Kumar Paswan,Rashtriya Lok Samta Party,2330,7,2337,1.35,227
3,4,Jitan Ram Manjhi,Hindustani Awam Morcha (Secular),78509,253,78762,45.36,227
4,5,Fakirchand Das,Jan Adhikar Party (Loktantrik),3781,16,3797,2.19,227
5,6,Banarsi Das,Peoples Party of India (Democratic),955,7,962,0.55,227
6,7,Lalan Kumar,Ambedkarite Party of India,1202,4,1206,0.69,227
7,8,Jitendra Chaudhari,Jagrook Janta Party,2032,1,2033,1.17,227
8,9,Deepak Ram,Independent,1337,2,1339,0.77,227
9,10,Bijendra Paswan,Independent,1577,2,1579,0.91,227
10,11,NOTA,None of the Above,4699,6,4705,2.71,227
0,1,RITA DEVI,Bahujan Samaj Party,9679,42,9721,5.26,228
1,2,RENUKA DEVI,Lok Jan Shakti Party,11144,100,11244,6.08,228
2,3,SAMATA DEVI,Rashtriya Janata Dal,65512,661,66173,35.79,228
3,4,JYOTI DEVI,Hindustani Awam Morcha (Secular),72249,242,72491,39.21,228
4,5,PARMESHWAR PASWAN,Bahujan Mukti Party,1873,20,1893,1.02,228
5,6,PRASHURAM MANJHI,Apna Kisan Party,1654,5,1659,0.9,228
6,7,BAL KUNWAR MANJHI,Jan Adhikar Party (Loktantrik),3116,11,3127,1.69,228
7,8,RAM BHAJAN MANAV,Shoshit Samaj Dal,1416,11,1427,0.77,228
8,9,REKHA DEVI,Jai Maha Bharath Party,1020,2,1022,0.55,228
9,10,SHIV SHANKAR KUMAR,Peoples Party of India (Democratic),1791,11,1802,0.97,228
10,11,ARJUN BHUIYAN,Independent,3816,20,3836,2.07,228
11,12,PUNIYA DEVI,Independent,3774,4,3778,2.04,228
12,13,SHIVCHARAN MANJHI,Independent,2956,6,2962,1.6,228
13,14,NOTA,None of the Above,3759,8,3767,2.04,228
0,1,AJAY PASWAN,Rashtriya Lok Samta Party,9276,35,9311,4.81,229
1,2,KUMAR SARVJEET,Rashtriya Janata Dal,80196,730,80926,41.84,229
2,3,SURESH PASWAN,Nationalist Congress Party,2109,6,2115,1.09,229
3,4,HARI MANJHI,Bharatiya Janata Party,75921,297,76218,39.4,229
4,5,KAILASH BHUIYAN,Apna Kisan Party,2062,0,2062,1.07,229
5,6,DILIP KUMAR CHOUDHARY,Rashtriya Jan Jan Party,1905,14,1919,0.99,229
6,7,BINDU VIKASH ATAL,Jagrook Janta Party,428,1,429,0.22,229
7,8,BED PRAKASH,Peoples Party of India (Democratic),779,12,791,0.41,229
8,9,MAHAVEER MANJHI,Bhartiya Insan Party,549,2,551,0.28,229
9,10,VIJAY KUMAR CHOUDHARY,Janta Dal Rashtravadi,1041,3,1044,0.54,229
10,11,VIJAY PASWAN,Sankhyanupati Bhagidari Party,1208,2,1210,0.63,229
11,12,SANJAY KUMAR CHOUDHARY,Bahujan Lok Dal,1996,2,1998,1.03,229
12,13,SATYENDRA KUMAR,Moolniwasi Samaj Party,3436,2,3438,1.78,229
13,14,OM PRAKASH PASWAN,Independent,1483,0,1483,0.77,229
14,15,PRAMILA KUMARI,Independent,3589,4,3593,1.86,229
15,16,RAVINDRA RAJWANSHI,Independent,2546,0,2546,1.32,229
16,17,SIMA KUMARI,Independent,1295,5,1300,0.67,229
17,18,NOTA,None of the Above,2495,5,2500,1.29,229
0,1,AKHAURI ONKAR NATH,Indian National Congress,54239,795,55034,41.02,230
1,2,PREM KUMAR,Bharatiya Janata Party,66362,570,66932,49.89,230
2,3,RANDHIR KUMAR KESHRI,Rashtriya Lok Samta Party,1044,10,1054,0.79,230
3,4,ANJANI KUMAR VAIDYASEN,Bhartiya Lok Chetna Party,185,3,188,0.14,230
4,5,ABUL FARAHA @ MD. ABUL FARAH,Bahujan Lok Dal,294,6,300,0.22,230
5,6,ADITYA PRADHAN,Peoples Party of India (Democratic),165,2,167,0.12,230
6,7,INDRA KUMAR,Hindu Samaj Party,190,1,191,0.14,230
7,8,GAUTAM KUMAR BABALU,Moolniwasi Samaj Party,244,3,247,0.18,230
8,9,DEEPAK ANAND,Rashtrawadi Janlok Party (Satya),221,1,222,0.17,230
9,10,DEEPAK KUMAR,Rashtriya Samaj Paksha,157,2,159,0.12,230
10,11,NIKIL KUMAR,Jan Adhikar Party (Loktantrik),300,3,303,0.23,230
11,12,PRAMENDRA KUMAR,Bhartiya Sablog Party,316,1,317,0.24,230
12,13,MD. PERWEZ MANSURI,Rashtriya Ulama Council,668,9,677,0.5,230
13,14,BEAUTY SINHA,Shiv Sena,377,4,381,0.28,230
14,15,MANOJ KUMAR TRIPATHI,Rashtriya Jan Jan Party,851,4,855,0.64,230
15,16,RINKU KUMAR,"Log Jan Party - Secular,",1098,1,1099,0.82,230
16,17,SHYAMLESH NARAYAN,Loktantrik Janshakti Party,866,2,868,0.65,230
17,18,SANJIT KUMAR,Bhartiya Lokmat Rashtrwadi Party,441,0,441,0.33,230
18,19,SUNIL KUMAR,Mazdoor Ekta Party,218,3,221,0.16,230
19,20,ANUJ KUMAR SINHA,Independent,117,2,119,0.09,230
20,21,AMIT KUMAR,Independent,102,2,104,0.08,230
21,22,ALKA SINGH,Independent,1135,18,1153,0.86,230
22,23,CHAITANYA PALIT,Independent,668,9,677,0.5,230
23,24,NARESH PRASAD,Independent,137,0,137,0.1,230
24,25,MUKESH KUMAR SINHA,Independent,126,1,127,0.09,230
25,26,RAJ KISHOR SINGH,Independent,175,1,176,0.13,230
26,27,RAMKUMAR YADAV,Independent,528,1,529,0.39,230
27,28,NOTA,None of the Above,1451,25,1476,1.1,230
0,1,Kamlesh Sharma,Lok Jan Shakti Party,16271,114,16385,8.78,231
1,2,Sheo Bachan Yadav,Bahujan Samaj Party,7276,20,7296,3.91,231
2,3,Sumant Kumar,Indian National Congress,67005,724,67729,36.28,231
3,4,Ajay Yadav,Jan Adhikar Party (Loktantrik),2381,16,2397,1.28,231
4,5,Anil Kumar,Hindustani Awam Morcha (Secular),69750,609,70359,37.69,231
5,6,Abita Devi,Rashtrawadi Janlok Party (Satya),1096,16,1112,0.6,231
6,7,Abhishek Singh,Sapaks Party,667,4,671,0.36,231
7,8,Kundan Kumar,Peoples Party of India (Democratic),509,6,515,0.28,231
8,9,Gopal Kumar,Bhartiya Lok Nayak Party,453,2,455,0.24,231
9,10,Chandan Kumar,Bharat Bhrashtachar Mitao Party,378,2,380,0.2,231
10,11,Janardan Sharma,Public Mission Party,607,0,607,0.33,231
11,12,Jitendra Mishra,Prabal Bharat Party,1313,5,1318,0.71,231
12,13,Dilip Kumar,Rashtriya Samaj Paksha,935,1,936,0.5,231
13,14,Punam Kumari,Shoshit Samaj Dal,2362,8,2370,1.27,231
14,15,Prasun Kumar,Bhartiya Lok Chetna Party,664,5,669,0.36,231
15,16,Ravish Kumar Raj,Bharatiya Jan Kranti Dal (Democratic),2871,1,2872,1.54,231
16,17,Ram Chandra Ajad,Akhil Hind Forward Bloc (Krantikari),1643,8,1651,0.88,231
17,18,Shivnarayan Mishra,Republican Party of India (Athawale),728,3,731,0.39,231
18,19,Santosh Kumar,Aam Janta Party Rashtriya,2068,7,2075,1.11,231
19,20,Har Deo Yadav,Loktantrik Samajwadi Party,472,1,473,0.25,231
20,21,Ashok Kumar,Independent,1144,2,1146,0.61,231
21,22,Kishor Kumar,Independent,448,0,448,0.24,231
22,23,Ranjan Radharj,Independent,1354,6,1360,0.73,231
23,24,Raushan Kumar Singh,Independent,1146,5,1151,0.62,231
24,25,Lalti Devi,Independent,386,4,390,0.21,231
25,26,NOTA,None of the Above,1151,20,1171,0.63,231
0,1,ABHAY KUMAR,Nationalist Congress Party,1294,16,1310,0.77,232
1,2,ABHAY KUMAR SINHA,Janata Dal (United),55340,405,55745,32.81,232
2,3,RAMASHRAY SHARMA,Lok Jan Shakti Party,11928,77,12005,7.07,232
3,4,SURENDRA PRASAD YADAV,Rashtriya Janata Dal,78856,852,79708,46.91,232
4,5,KUSUM KUMARI,Peoples Party of India (Democratic),1428,12,1440,0.85,232
5,6,GUPTESHWAR KUMAR BHARTI,Swabhiman Party,604,1,605,0.36,232
6,7,MOHAMMED EKRAM,Samajwadi Janata Dal Democratic,3773,30,3803,2.24,232
7,8,SHAHADAT HUSSAIN,Bharat Bhrashtachar Mitao Party,692,0,692,0.41,232
8,9,SOHARAI PASWAN,Public Mission Party,881,2,883,0.52,232
9,10,ARUN KUMAR,Independent,1795,8,1803,1.06,232
10,11,GEETA DEVI,Independent,2628,7,2635,1.55,232
11,12,MOHAMMED IQBAL,Independent,1796,0,1796,1.06,232
12,13,SYED SHARIM ALI,Independent,4398,13,4411,2.6,232
13,14,NOTA,None of the Above,3068,3,3071,1.81,232
0,1,AJAY KUMAR SINHA,Rashtriya Lok Samta Party,9384,58,9442,5.51,233
1,2,AJAY YADAV,Rashtriya Janata Dal,61682,976,62658,36.55,233
2,3,ARVIND KUMAR SINGH,Lok Jan Shakti Party,25537,336,25873,15.09,233
3,4,MANORMA DEVI,Janata Dal (United),54104,623,54727,31.93,233
4,5,SHASHI KUMAR,Pragatisheel Magahi Samaj,1813,15,1828,1.07,233
5,6,KUMARI VEENA,Independent,1204,16,1220,0.71,233
6,7,GAURAV KUMAR SINHA,Independent,1215,7,1222,0.71,233
7,8,CHANDRIKA PRASAD,Independent,1880,13,1893,1.1,233
8,9,MANOJ YADAV,Independent,2649,2,2651,1.55,233
9,10,RAM LAKHAN YADAV,Independent,2304,3,2307,1.35,233
10,11,SUBHAS CHANDRA BOSE,Independent,3020,16,3036,1.77,233
11,12,NOTA,None of the Above,4543,18,4561,2.66,233
0,1,Birendra Singh,Bharatiya Janata Party,70325,388,70713,40.23,234
1,2,SHASHI SHEKHAR Singh,Indian National Congress,47903,380,48283,27.47,234
2,3,Shreedhar Prasad,Rashtriya Lok Samta Party,7347,43,7390,4.2,234
3,4,INDRAN PASWAN,Peoples Party of India (Democratic),774,4,778,0.44,234
4,5,CHITRANJAN KUMAR,Bhartiya Sablog Party,11127,35,11162,6.35,234
5,6,JWALA MEHTA,Bahujan Lok Dal,753,0,753,0.43,234
6,7,Dipak Kumar,Bhartiya Rashtriya Dal,496,2,498,0.28,234
7,8,MRITYUNJAY Kumar Singh,Shiv Sena,634,1,635,0.36,234
8,9,Rajiv Kumar,Jan Adhikar Party (Loktantrik),3715,7,3722,2.12,234
9,10,Raju Saw,Sankhyanupati Bhagidari Party,1043,1,1044,0.59,234
10,11,Ram Prasad Manjhi,Jagrook Janta Party,665,0,665,0.38,234
11,12,Sanjay Prasad,Bharat Bhrashtachar Mitao Party,985,0,985,0.56,234
12,13,Suman Saurav,Prabal Bharat Party,677,0,677,0.39,234
13,14,BINOD DAS,Independent,864,2,866,0.49,234
14,15,Ranjay Kumar Singh,Independent,1974,0,1974,1.12,234
15,16,Rajendra Kumar Verma,Independent,3170,0,3170,1.8,234
16,17,Ram bilash Prasad,Independent,2427,1,2428,1.38,234
17,18,Ram Vijay Paswan,Independent,961,1,962,0.55,234
18,19,RITA DEVI,Independent,577,5,582,0.33,234
19,20,Vandana Singh,Independent,2121,2,2123,1.21,234
20,21,Shital Prasad Yadav,Independent,14088,85,14173,8.06,234
21,22,SURAJ KUMAR,Independent,658,0,658,0.37,234
22,23,NOTA,None of the Above,1540,8,1548,0.88,234
0,1,KANHAIYA KUMAR,Bharatiya Janata Party,57121,270,57391,34.22,235
1,2,PRAKASH VEER,Rashtriya Janata Dal,69287,697,69984,41.72,235
2,3,MITHILESH RAJVANSHI,Rashtriya Lok Samta Party,1523,6,1529,0.91,235
3,4,DILIP PASWAN,Rashtriya Samaj Paksha,567,3,570,0.34,235
4,5,DEEPAK KUMAR,Jan Adhikar Party (Loktantrik),909,8,917,0.55,235
5,6,DURGA RAJBANSHI,Peoples Party of India (Democratic),280,0,280,0.17,235
6,7,DUSHYANT PASWAN,Jai Maha Bharath Party,291,0,291,0.17,235
7,8,NARESH RAM,Shoshit Samaj Dal,363,2,365,0.22,235
8,9,PRIYANKA DEVI,Moolniwasi Samaj Party,333,1,334,0.2,235
9,10,MOHAN CHAUDHARY,Prabal Bharat Party,499,1,500,0.3,235
10,11,VISHWANATH TANTI,Loktantrik Janshakti Party,540,2,542,0.32,235
11,12,SHYAM SUNDAR KUMAR RAVI,Bhartiya Sablog Party,687,1,688,0.41,235
12,13,ARJUN RAM,Independent,14290,104,14394,8.58,235
13,14,CHANDAN KUMAR CHAUDHARY,Independent,1071,1,1072,0.64,235
14,15,PRITHAVIRAJ BASANT,Independent,2294,2,2296,1.37,235
15,16,PREMA CHAUDHARY,Independent,5289,20,5309,3.17,235
16,17,BANWARI RAM,Independent,3476,30,3506,2.09,235
17,18,BALMIKI RAM,Independent,1955,1,1956,1.17,235
18,19,RANJIT KUMAR,Independent,2206,13,2219,1.32,235
19,20,RABINDRA RAJBANSHI,Independent,816,0,816,0.49,235
20,21,RAKESH KUMAR,Independent,919,7,926,0.55,235
21,22,SHRAVAN KUMAR,Independent,657,5,662,0.39,235
22,23,NOTA,None of the Above,1176,12,1188,0.71,235
0,1,Anil Singh,Bharatiya Janata Party,77252,587,77839,40.84,236
1,2,Uttam Kumar Chaudhary,Bahujan Samaj Party,3683,13,3696,1.94,236
2,3,NITU KUMARI,Indian National Congress,94027,903,94930,49.81,236
3,4,ANIL KUMAR SHARMA,Rashtriya Jan Jan Party,2879,11,2890,1.52,236
4,5,SUDHIR KUMAR,Shoshit Samaj Dal,1148,9,1157,0.61,236
5,6,SURESH PASWAN,Peoples Party of India (Democratic),1287,8,1295,0.68,236
6,7,Azad Geeta Prasad Sharma,Independent,3275,6,3281,1.72,236
7,8,GANESH RAJVANSHI,Independent,1186,4,1190,0.62,236
8,9,NOTA,None of the Above,4306,16,4322,2.27,236
0,1,Kaushal Yadav,Janata Dal (United),34194,373,34567,19.12,237
1,2,Dhirendra Kumar,Rashtriya Lok Samta Party,2199,13,2212,1.22,237
2,3,Vibha Devi,Rashtriya Janata Dal,71618,817,72435,40.06,237
3,4,Shashi Bhushan Kumar,Lok Jan Shakti Party,3026,64,3090,1.71,237
4,5,Rajesh Kumar Nirala,"Hindustani Awam Manch (United),",466,4,470,0.26,237
5,6,Satish Kumar,Peoples Party of India (Democratic),324,3,327,0.18,237
6,7,Dinesh Prasad,Independent,581,2,583,0.32,237
7,8,Dhirendra Kumar Sinha Munna,Independent,9601,83,9684,5.36,237
8,9,Naresh Ravidas,Independent,525,3,528,0.29,237
9,10,Bablu Kumar,Independent,531,9,540,0.3,237
10,11,Bawan Yadav,Independent,505,0,505,0.28,237
11,12,Rajendra Prasad Sahu,Independent,3940,92,4032,2.23,237
12,13,Vineshwar Yadav,Independent,1606,0,1606,0.89,237
13,14,Sharwan Kumar S/o-Deva Mahto,Independent,45783,342,46125,25.51,237
14,15,Shravan Kumar S/o-Maholal Sao,Independent,1193,4,1197,0.66,237
15,16,NOTA,None of the Above,2913,17,2930,1.62,237
0,1,PURNIMA YADAV,Janata Dal (United),46243,240,46483,28.75,238
1,2,MD KAMRAN,Rashtriya Janata Dal,79019,538,79557,49.21,238
2,3,RANJIT PD. YADAV,Lok Jan Shakti Party,16046,65,16111,9.96,238
3,4,BISHUN DEV YADAV,Bahujan Samaj Party,743,4,747,0.46,238
4,5,ANAND PRIYA DEO,Rajnaitik Chetna Dal,3091,19,3110,1.92,238
5,6,GANAURI PANDIT,Peoples Party of India (Democratic),441,6,447,0.28,238
6,7,DEENANATH THAKUR,Janata Party,479,1,480,0.3,238
7,8,VISHWAS VISHWAKARMA,"Log Jan Party - Secular,",365,2,367,0.23,238
8,9,HIRADAYA DEVI,Janata Dal  (Secular),833,3,836,0.52,238
9,10,ARUN KUMAR,Independent,469,2,471,0.29,238
10,11,UPENDRA RAJBANSHI,Independent,418,1,419,0.26,238
11,12,DAYA NAND PRASAD,Independent,732,3,735,0.45,238
12,13,DINESH SINGH CHANDRAVANSI,Independent,1544,2,1546,0.96,238
13,14,DILIP KUMAR,Independent,1918,1,1919,1.19,238
14,15,RAM YATNA SINGH,Independent,3797,0,3797,2.35,238
15,16,NOTA,None of the Above,4650,7,4657,2.88,238
0,1,Aruna Devi,Bharatiya Janata Party,61906,545,62451,36.49,239
1,2,Rajendra Prasad,Rashtriya Lok Samta Party,4712,43,4755,2.78,239
2,3,Satish Kumar,Indian National Congress,52833,588,53421,31.22,239
3,4,Krishna Deo Chaudhari,Bahujan Mukti Party,1491,18,1509,0.88,239
4,5,Balmiki Prasad,Peoples Party of India (Democratic),605,4,609,0.36,239
5,6,Ranjeet Yadav,Jagrook Janta Party,490,4,494,0.29,239
6,7,Sanjay Kumar Yadav,Jan Adhikar Party (Loktantrik),739,3,742,0.43,239
7,8,Sumit Raj,Rashtriya Jan Jan Party,2368,14,2382,1.39,239
8,9,Arti Sinha,Independent,39121,242,39363,23,239
9,10,Pramod Kumar,Independent,1390,0,1390,0.81,239
10,11,NOTA,None of the Above,3999,11,4010,2.34,239
0,1,NANDLAL RAVIDAS,Rashtriya Lok Samta Party,7259,25,7284,4.75,240
1,2,RAVISHANKAR PASWAN,Lok Jan Shakti Party,10614,89,10703,6.98,240
2,3,SUDHIR KUMAR,Indian National Congress,41233,323,41556,27.09,240
3,4,PRAFULL KUMAR MANJHI,Hindustani Awam Morcha (Secular),46901,160,47061,30.67,240
4,5,BRAHAMDEO ANAND PASWAN,"Aam Janmat Party,",1752,10,1762,1.15,240
5,6,RAJ KUMAR PASWAN,Jantantrik Lokhit Party,832,1,833,0.54,240
6,7,REWA RAVIDAS,Bhartiya Sablog Party,1013,7,1020,0.66,240
7,8,VISHNU PRIYA,Bahujan Mukti Party,1408,26,1434,0.93,240
8,9,SHIV BALAK PASWAN,Peoples Party of India (Democratic),1057,6,1063,0.69,240
9,10,Er. INDRAJEET PRASAD GUPTA,Independent,7540,36,7576,4.94,240
10,11,DHARMENDRA PASWAN,Independent,2016,9,2025,1.32,240
11,12,RAMESHWAR PASWAN,Independent,2139,14,2153,1.4,240
12,13,SHIV SHANKAR CHOUDHARY,Independent,3084,29,3113,2.03,240
13,14,SINDHU KUMAR PASWAN,Independent,4705,19,4724,3.08,240
14,15,SUBHASH CHANDRA BOSH,Independent,17995,110,18105,11.8,240
15,16,NOTA,None of the Above,3005,9,3014,1.96,240
0,1,AJAY PRATAP,Rashtriya Lok Samta Party,15559,153,15712,8.66,241
1,2,VIJAY PRAKASH,Rashtriya Janata Dal,38147,407,38554,21.26,241
2,3,SHREYASI SINGH,Bharatiya Janata Party,79156,447,79603,43.89,241
3,4,MD ABDUL BAKI,Janta Dal Rashtravadi,1212,4,1216,0.67,241
4,5,DINESH KUMAR,Jawan Kisan Morcha,433,2,435,0.24,241
5,6,NAKUL KUMAR SHARMA,"Log Jan Party - Secular,",439,3,442,0.24,241
6,7,MOHAMMAD SHAMSAD ALAM,Jan Adhikar Party (Loktantrik),17733,67,17800,9.81,241
7,8,RABINDRA MONDAL,Peoples Party of India (Democratic),979,3,982,0.54,241
8,9,SURYA PRAKASH SINHA,Janata Party,789,7,796,0.44,241
9,10,NANDLAL  SINGH,Independent,383,0,383,0.21,241
10,11,MAHABIR YADAV,Independent,358,3,361,0.2,241
11,12,RANJIT SHARMA,Independent,1027,1,1028,0.57,241
12,13,RAMAVATAR KUMAR CHANDRAVANSHI,Independent,3595,0,3595,1.98,241
13,14,SUJATA SINGH,Independent,17420,82,17502,9.65,241
14,15,NOTA,None of the Above,2944,11,2955,1.63,241
0,1,DAMODAR RAWAT,Janata Dal (United),76595,377,76972,39.55,242
1,2,RABINDRA YADAV,Lok Jan Shakti Party,11686,76,11762,6.04,242
2,3,RAJENDRA PRASAD,Rashtriya Janata Dal,74816,477,75293,38.69,242
3,4,BINOD PD. YADAV,Bahujan Samaj Party,13416,63,13479,6.93,242
4,5,AJEET KUMAR,Jharkhand Mukti Morcha,1181,5,1186,0.61,242
5,6,PANKAJ THAKUR,Independent,777,0,777,0.4,242
6,7,MUKESH KUMAR YADAV,Independent,759,1,760,0.39,242
7,8,RAHUL KUMAR SINGH,Independent,3257,3,3260,1.68,242
8,9,VIJAY KUMAR,Independent,2970,2,2972,1.53,242
9,10,VINOD KUMAR SINHA,Independent,1865,5,1870,0.96,242
10,11,NOTA,None of the Above,6271,7,6278,3.23,242
0,1,SANJAY KUMAR MANDAL,Lok Jan Shakti Party,22575,60,22635,11.94,243
1,2,SANJAY PRASAD,Janata Dal (United),39205,114,39319,20.73,243
2,3,SAVITRI DEVI,Rashtriya Janata Dal,44721,246,44967,23.71,243
3,4,SITARAM SAW,Bahujan Samaj Party,2671,8,2679,1.41,243
4,5,ABHIMANYU KUMAR MISHRA,Sarvhara Dal,838,4,842,0.44,243
5,6,AMARENDRA KUMAR,Bahujan Mukti Party,1097,4,1101,0.58,243
6,7,ELIZABETH SOREN,Jharkhand Mukti Morcha,16881,104,16985,8.96,243
7,8,MD. TABREZ ANSARI,Bhartiya Lokmat Rashtrwadi Party,1039,1,1040,0.55,243
8,9,NANDU YADAV,Peoples Party of India (Democratic),951,1,952,0.5,243
9,10,BAM BHOLA YADAV,Independent,916,1,917,0.48,243
10,11,RAHUL KUMAR,Independent,1899,3,1902,1,243
11,12,SANJAY PANDEY,Independent,4234,3,4237,2.23,243
12,13,SUMIT KUMAR SINGH,Independent,45375,173,45548,24.02,243
13,14,NOTA,None of the Above,6520,1,6521,3.44,243
